Item	Category	Sources
Aged Eye of Fire	Desynth	Aged Ring
Aged Mortar Pieces	Desynth	Aged Mortar
Aged Pestle Pieces	Desynth	Aged Pestle
Aged Spear Shaft	Desynth	Aged Spear
Aged Vellum	Desynth	Aged Grimoire
Allagan Silk	Desynth	Blood Red Bonytongue
Allagan Wootz Nugget	Desynth	Wootz Knifefish Zenith	High Allagan Helmet
Ash Lumber	Desynth	Aged Spear
Assassin Fry	Desynth	Ninja Betta
Astral Birch Lumber	Desynth	Handmaster's Earrings
Battlecraft Demimateria I	Desynth
Battlecraft Demimateria II	Desynth
Battlecraft Demimateria III	Desynth
Brimstone	Desynth	Aged Phial
Clear Demimateria II	Desynth	Aged Phial	Aged Robe	Aged Spear
Cooking Sherry	Desynth	Aged Decanter
Coronal Summer Halter	Desynth	Frilled Shark
Cotton Yarn	Desynth	Aged Robe
Dark Vinegar	Desynth	Aged Decanter
Demimateria of Crags	Desynth
Demimateria of the Inferno	Desynth
Demimateria of the Vortex	Desynth
Dew Thread	Desynth	Aged Robe
Dried Ether	Desynth	Aged Phial
Elm Lumber	Desynth	Aged Spear
Fieldcraft Demimateria I	Desynth
Fieldcraft Demimateria II	Desynth
Fieldcraft Demimateria III	Desynth	Best Man's Gaiters	Best Man's Jacket	Best Man's Slacks	Bridesmaid's Dress	Bridesmaid's Sandals	Bridesmaid's Tights	Handmaster's Earrings	Dinosaur Leather Gloves	Imperial Shadow Visor
Garnet	Desynth	Aged Ring
Glass Fiber	Desynth	Handmaster's Earrings
Gold Roselle Capeline	Desynth	Toramafish
Hard Leather	Desynth	Aged Grimoire
Iron Ingot	Desynth	Aged Mortar	Aged Pestle	Aged Spear
Leather	Desynth	Aged Grimoire
Mastercraft Demimateria	Desynth
Natron	Desynth	Aged Phial
Oschon Roselle Capeline	Desynth	The Greatest Bream in the World
Polarized Glass	Desynth	Imperial Shadow Visor
Pterodactyl Leather	Desynth	Magma Louse
Red Summer Maro	Desynth	Twitchbeard
Red Summer Pareo	Desynth	Twitchbeard
Sea Breeze Summer Halter	Desynth	Gigantshark
Sea Breeze Summer Pareo	Desynth	Octomammoth
Silver Ingot	Desynth	Aged Ring
Sour Red	Desynth	Aged Decanter
South Seas Talisman	Desynth	Gigantshark
Stained Cloth	Desynth	Aged Robe
Steel Ingot	Desynth	Aged Mortar	Aged Pestle	Aged Spear
Stormsap	Desynth	The Word of God
Summer Sandals	Desynth	Shark Tuna	Magic Carpet	Spearnose
Sunstone	Desynth	Aged Ring
Ti Leaf Lei	Desynth	Frilled Shark
Undyed Cotton Cloth	Desynth	Aged Robe
Undyed Velveteen	Desynth	Aged Robe
Vintage Cooking Sherry	Desynth	Aged Decanter
Vitriol	Desynth	Aged Phial
Waterproof Cotton Cloth	Desynth	Sweetnewt	The Lone Ripper	Olgoi-Khorkhoi	Shrieker
Duskborne Aethersand	Reduce	Fire Moraine	Lightning Moraine	Granular Clay	Pot Marjoram
Dawnborne Aethersand	Reduce	Bright Fire Rock	Bright Lightning Rock	Peat Moss	Water Mint
Landborne Aethersand	Reduce	Radiant Fire Moraine	Radiant Lightning Moraine
Leafborne Aethersand	Reduce	Humic Soil	Wild Sage
Seaborne Aethersand	Reduce	Thaliak Caiman	Tupuxuara
Light-kissed Aethersand	Reduce	Lover's Laurel	Radiant Astral Moraine
Dawnlight Aethersand	Reduce	Schorl	Countess Tea Leaves	Snow Crab
Everbright Aethersand	Reduce	Dacite
Dusklight Aethersand	Reduce	Doman Yellow	Rhodolite	False Scad
Everdeep Aethersand	Reduce	Sweatfish
Everborn Aethersand	Reduce	Torreya Branch
Duskglow Aethersand	Reduce	Yanxian Soil	Yanxian Verbena
Agedeep Aethersand	Reduce	Shade Quartz
Chiaroglow Aethersand	Reduce	Gale Rock	White Clay	Voeburt Bichir
Scuroglow Aethersand	Reduce	Sweet Marjoram	Solarite	Poecilia
Agewood Aethersand	Reduce	Bog Sage
Ageflow Aethersand	Reduce	Predator
Earth Cluster	Reduce	Humic Soil	Doman Yellow	Granular Clay	Peat Moss	White Clay	Thunder Rock
Earth Crystal	Reduce	Humic Soil	Doman Yellow	Granular Clay	Peat Moss	White Clay	Thunder Rock
Fire Cluster	Reduce	Rhodolite	Bright Fire Rock	Fire Moraine	Radiant Fire Moraine	Shade Quartz
Fire Crystal	Reduce	Rhodolite	Bright Fire Rock	Fire Moraine	Radiant Fire Moraine	Shade Quartz
Ice Cluster	Reduce	Lover's Laurel	Torreya Branch	Bog Sage	Voeburt Bichir	Fuchsia Bloom
Ice Crystal	Reduce	Lover's Laurel	Torreya Branch	Bog Sage	Voeburt Bichir	Fuchsia Bloom
Lightning Cluster	Reduce	Bright Lightning Rock	Lightning Moraine	Radiant Lightning Moraine	Schorl	Yanxian Verbena	Solarite	Levin Mint
Lightning Crystal	Reduce	Bright Lightning Rock	Lightning Moraine	Radiant Lightning Moraine	Schorl	Yanxian Verbena	Solarite	Levin Mint
Water Cluster	Reduce	Radiant Astral Moraine	Dacite	Gale Rock	Poecilia
Water Crystal	Reduce	Radiant Astral Moraine	Dacite	Gale Rock	Poecilia
Wind Cluster	Reduce	Wild Sage	Water Mint	Pot Marjoram	Countess Tea Leaves	Yanxian Soil	Sweet Marjoram
Wind Crystal	Reduce	Wild Sage	Water Mint	Pot Marjoram	Countess Tea Leaves	Yanxian Soil	Sweet Marjoram
Levinstrike Aethersand	Reduce	Levin Mint	Thunder Rock	Fuchsia Bloom
Moonlight Aethersand	Reduce	Gilled Topknot	Red Bowfin	Lunar Quartz	Ewer Clay
Endwood Aethersand	Reduce	Palm Chippings
Endstone Aethersand	Reduce	Ghostly Umbral Rock
Endtide Aethersand	Reduce	Eehs Forhnesh	Othardian Lumpsucker
Fire Shard	Loot	Timeworn Leather Map	Timeworn Goatskin Map	Timeworn Toadskin Map	Timeworn Boarskin Map	Timeworn Peisteskin Map
Ice Shard	Loot	Timeworn Leather Map	Timeworn Goatskin Map	Timeworn Toadskin Map	Timeworn Boarskin Map	Timeworn Peisteskin Map
Wind Shard	Loot	Timeworn Leather Map	Timeworn Goatskin Map	Timeworn Toadskin Map	Timeworn Boarskin Map	Timeworn Peisteskin Map
Earth Shard	Loot	Timeworn Leather Map	Timeworn Goatskin Map	Timeworn Toadskin Map	Timeworn Boarskin Map	Timeworn Peisteskin Map
Lightning Shard	Loot	Timeworn Leather Map	Timeworn Goatskin Map	Timeworn Toadskin Map	Timeworn Boarskin Map	Timeworn Peisteskin Map
Water Shard	Loot	Timeworn Leather Map	Timeworn Goatskin Map	Timeworn Toadskin Map	Timeworn Boarskin Map	Timeworn Peisteskin Map
Faded Copy of The Only Path	Loot	Timeworn Leather Map	Timeworn Goatskin Map	Unhidden Leather Map	Timeworn Wyvernskin Map	Timeworn Dragonskin Map
Ahriman Tears	Loot	Timeworn Leather Map	Unhidden Leather Map
Lotus Leaf	Loot	Timeworn Leather Map
Moonstone	Loot	Timeworn Leather Map	Timeworn Goatskin Map
Unhidden Leather Map	Loot	Timeworn Leather Map	Timeworn Goatskin Map	Timeworn Peisteskin Map	Timeworn Archaeoskin Map	Timeworn Wyvernskin Map	Timeworn Dragonskin Map
Aetherial Mythril Spectacles	Loot	Timeworn Leather Map
Aetherial Linen Turban	Loot	Timeworn Leather Map
Aetherial Linen Hat	Loot	Timeworn Leather Map
Aetherial Heavy Steel Armor	Loot	Timeworn Leather Map
Aetherial Linen Cowl	Loot	Timeworn Leather Map
Aetherial Linen Robe	Loot	Timeworn Leather Map
Aetherial Linen Shirt	Loot	Timeworn Leather Map
Aetherial Boarskin Ringbands	Loot	Timeworn Leather Map
Aetherial Fingerless Boarskin Gloves	Loot	Timeworn Leather Map
Aetherial Heavy Steel Gauntlets	Loot	Timeworn Leather Map
Aetherial Mythril Gauntlets	Loot	Timeworn Leather Map
Aetherial Boarskin Satchel Belt	Loot	Timeworn Leather Map
Aetherial Linen Longsash	Loot	Timeworn Leather Map
Aetherial Reinforced Steel Plate Belt	Loot	Timeworn Leather Map
Aetherial Linen Sarouel	Loot	Timeworn Leather Map
Aetherial Linen Tights	Loot	Timeworn Leather Map
Aetherial Linen Trousers	Loot	Timeworn Leather Map
Aetherial Boarskin Crakows	Loot	Timeworn Leather Map
Aetherial Heavy Steel Flanchard	Loot	Timeworn Leather Map
Aetherial Steel-plated Caligae	Loot	Timeworn Leather Map
Aetherial Toadskin Duckbills	Loot	Timeworn Leather Map
Aldgoat Horn	Loot	Timeworn Leather Map
Walnut Lumber	Loot	Timeworn Leather Map	Timeworn Goatskin Map
Oak Lumber	Loot	Timeworn Leather Map	Timeworn Goatskin Map
Iron Ingot	Loot	Timeworn Leather Map
Steel Ingot	Loot	Timeworn Leather Map	Timeworn Goatskin Map
Steel Rivets	Loot	Timeworn Leather Map
Mythril Ingot	Loot	Timeworn Leather Map	Timeworn Goatskin Map	Timeworn Toadskin Map
Silver Ingot	Loot	Timeworn Leather Map	Timeworn Goatskin Map
Siltstone Whetstone	Loot	Timeworn Leather Map
Electrum Ingot	Loot	Timeworn Leather Map	Timeworn Goatskin Map	Timeworn Toadskin Map
Hard Leather	Loot	Timeworn Leather Map
Aldgoat Leather	Loot	Timeworn Leather Map	Timeworn Toadskin Map
Toad Leather	Loot	Timeworn Leather Map
Boar Leather	Loot	Timeworn Leather Map
Peiste Leather	Loot	Timeworn Leather Map
Undyed Velveteen	Loot	Timeworn Leather Map
Linen Yarn	Loot	Timeworn Leather Map	Timeworn Goatskin Map
Undyed Linen	Loot	Timeworn Leather Map	Timeworn Goatskin Map
Woolen Yarn	Loot	Timeworn Leather Map
Horn Glue	Loot	Timeworn Leather Map
Growth Formula Gamma	Loot	Timeworn Leather Map
Hi-Ether	Loot	Timeworn Leather Map	Timeworn Goatskin Map
Hi-Potion	Loot	Timeworn Leather Map	Timeworn Goatskin Map
Hi-Potion of Strength	Loot	Timeworn Leather Map	Timeworn Goatskin Map	Timeworn Toadskin Map
Hi-Potion of Dexterity	Loot	Timeworn Leather Map	Timeworn Goatskin Map	Timeworn Toadskin Map
Hi-Potion of Vitality	Loot	Timeworn Leather Map	Timeworn Goatskin Map	Timeworn Toadskin Map
Hi-Potion of Intelligence	Loot	Timeworn Leather Map	Timeworn Goatskin Map	Timeworn Toadskin Map
Hi-Potion of Mind	Loot	Timeworn Leather Map	Timeworn Goatskin Map	Timeworn Toadskin Map
Cordial	Loot	Timeworn Leather Map	Timeworn Goatskin Map	Timeworn Toadskin Map
Blue Fox Hide	Loot	Timeworn Goatskin Map	Timeworn Peisteskin Map	Timeworn Dragonskin Map	Timeworn Wyvernskin Map
Exquisite Buttons	Loot	Timeworn Goatskin Map	Timeworn Archaeoskin Map	Timeworn Wyvernskin Map	Timeworn Dragonskin Map	Unhidden Leather Map
Aetherial Mythril Celata	Loot	Timeworn Goatskin Map
Aetherial Ranger's Hat	Loot	Timeworn Goatskin Map
Aetherial Mythril Cuirass	Loot	Timeworn Goatskin Map
Aetherial Mythril Haubergeon	Loot	Timeworn Goatskin Map
Aetherial Woolen Shirt	Loot	Timeworn Goatskin Map
Aetherial Mythril Plate Belt	Loot	Timeworn Goatskin Map
Aetherial Peisteskin Hunting Belt	Loot	Timeworn Goatskin Map
Aetherial Woolen Sash	Loot	Timeworn Goatskin Map
Aetherial Fingerless Raptorskin Gloves	Loot	Timeworn Goatskin Map
Aetherial Woolen Dress Gloves	Loot	Timeworn Goatskin Map
Aetherial Boarskin Skirt	Loot	Timeworn Goatskin Map
Aetherial High Mythril Flanchard	Loot	Timeworn Goatskin Map
Aetherial Padded Linen Trousers	Loot	Timeworn Goatskin Map
Aetherial Woolen Dress Shoes	Loot	Timeworn Goatskin Map
Aetherial Woolen Kecks	Loot	Timeworn Goatskin Map
Aetherial Boarskin Duckbills	Loot	Timeworn Goatskin Map
Aetherial Mythril Sabatons	Loot	Timeworn Goatskin Map
Aetherial Peisteskin Crakows	Loot	Timeworn Goatskin Map
Aetherial Red Coral Ring	Loot	Timeworn Goatskin Map
Cactuar Needle	Loot	Timeworn Goatskin Map
Hippogryph Sinew	Loot	Timeworn Goatskin Map
Red Coral	Loot	Timeworn Goatskin Map
Mahogany Lumber	Loot	Timeworn Goatskin Map
Cobalt Ingot	Loot	Timeworn Goatskin Map	Timeworn Toadskin Map
Steel Plate	Loot	Timeworn Goatskin Map
Mythril Plate	Loot	Timeworn Goatskin Map
Raptor Leather	Loot	Timeworn Goatskin Map
Undyed Woolen Cloth	Loot	Timeworn Goatskin Map	Timeworn Toadskin Map
Undyed Felt	Loot	Timeworn Goatskin Map
Clear Glass Lens	Loot	Timeworn Goatskin Map
Enchanted Mythril Ink	Loot	Timeworn Goatskin Map
Cutting Oil	Loot	Timeworn Toadskin Map	Timeworn Peisteskin Map	Unhidden Leather Map
Cobalt Plate	Loot	Timeworn Toadskin Map
Rush Grass	Loot	Timeworn Toadskin Map	Timeworn Dragonskin Map
Tiny Bulb	Loot	Timeworn Toadskin Map
Morbol Saliva	Loot	Timeworn Toadskin Map	Unhidden Leather Map
Aetherial Cobalt Sabatons	Loot	Timeworn Toadskin Map
Aetherial Red Coral Necklace	Loot	Timeworn Toadskin Map
Aetherial Electrum Wristlets	Loot	Timeworn Toadskin Map
Pudding Flesh	Loot	Timeworn Toadskin Map
Rosewood Lumber	Loot	Timeworn Toadskin Map
Swan Feather	Loot	Timeworn Boarskin Map
Mariner Cotton Cloth	Loot	Timeworn Boarskin Map	Unhidden Leather Map
Eagle Feather	Loot	Timeworn Boarskin Map
Wind-up Tonberry	Loot	Timeworn Boarskin Map
Aqueous Whetstone	Loot	Timeworn Boarskin Map	Unhidden Leather Map
Belah'dian Silver	Loot	Timeworn Boarskin Map	Timeworn Peisteskin Map	Unhidden Leather Map
Raptor Sinew	Loot	Timeworn Boarskin Map
Bluebird	Loot	Timeworn Peisteskin Map	Timeworn Dragonskin Map
Chinchilla Hide	Loot	Timeworn Peisteskin Map	Unhidden Leather Map
Dress Material	Loot	Timeworn Peisteskin Map	Unhidden Leather Map
Frosted Glass Lens	Loot	Timeworn Peisteskin Map	Unhidden Leather Map
Astral Rock	Loot	Timeworn Peisteskin Map
Coeurl Skin	Loot	Timeworn Peisteskin Map
Minium	Loot	Timeworn Peisteskin Map
Treant Sap	Loot	Timeworn Peisteskin Map
Vampire Plant	Loot	Timeworn Peisteskin Map
Astral Eye	Loot	Timeworn Peisteskin Map
Undyed Felt	Loot	Timeworn Peisteskin Map
Mega-Potion of Strength	Loot	Timeworn Peisteskin Map
Mega-Potion of Dexterity	Loot	Timeworn Peisteskin Map
Mega-Potion of Vitality	Loot	Timeworn Peisteskin Map
Mega-Potion of Intelligence	Loot	Timeworn Peisteskin Map
Mega-Potion of Mind	Loot	Timeworn Peisteskin Map
Fire Cluster	Loot	Unhidden Leather Map
Ice Cluster	Loot	Unhidden Leather Map
Wind Cluster	Loot	Unhidden Leather Map
Earth Cluster	Loot	Unhidden Leather Map
Lightning Cluster	Loot	Unhidden Leather Map
Water Cluster	Loot	Unhidden Leather Map
Imitation Mistbeard Mask	Loot	Unhidden Leather Map
Imperial Shadow Visor	Loot	Unhidden Leather Map
Mist Silk	Loot	Unhidden Leather Map
Nutkin	Loot	Unhidden Leather Map
Polarized Glass	Loot	Unhidden Leather Map
Spriggan Cap	Loot	Unhidden Leather Map
Animal Fat	Loot	Unhidden Leather Map
Grade 3 La Noscean Topsoil	Loot	Unhidden Leather Map
Grade 3 Shroud Topsoil	Loot	Unhidden Leather Map
Grade 3 Thanalan Topsoil	Loot	Unhidden Leather Map
Fire Crystal	Loot	Timeworn Archaeoskin Map	Timeworn Wyvernskin Map	Timeworn Dragonskin Map	Timeworn Gaganaskin Map	Timeworn Gazelleskin Map	Timeworn Gliderskin Map	Timeworn Zonureskin Map
Ice Crystal	Loot	Timeworn Archaeoskin Map	Timeworn Wyvernskin Map	Timeworn Dragonskin Map	Timeworn Gaganaskin Map	Timeworn Gazelleskin Map	Timeworn Gliderskin Map	Timeworn Zonureskin Map
Wind Crystal	Loot	Timeworn Archaeoskin Map	Timeworn Wyvernskin Map	Timeworn Dragonskin Map	Timeworn Gaganaskin Map	Timeworn Gazelleskin Map	Timeworn Gliderskin Map	Timeworn Zonureskin Map
Earth Crystal	Loot	Timeworn Archaeoskin Map	Timeworn Wyvernskin Map	Timeworn Dragonskin Map	Timeworn Gaganaskin Map	Timeworn Gazelleskin Map	Timeworn Gliderskin Map	Timeworn Zonureskin Map
Lightning Crystal	Loot	Timeworn Archaeoskin Map	Timeworn Wyvernskin Map	Timeworn Dragonskin Map	Timeworn Gaganaskin Map	Timeworn Gazelleskin Map	Timeworn Gliderskin Map	Timeworn Zonureskin Map
Water Crystal	Loot	Timeworn Archaeoskin Map	Timeworn Wyvernskin Map	Timeworn Dragonskin Map	Timeworn Gaganaskin Map	Timeworn Gazelleskin Map	Timeworn Gliderskin Map	Timeworn Zonureskin Map
Pneumite	Loot	Timeworn Archaeoskin Map	Timeworn Wyvernskin Map
Yeti Fang	Loot	Timeworn Archaeoskin Map
Holy Cedar Lumber	Loot	Timeworn Archaeoskin Map
Dark Chestnut Lumber	Loot	Timeworn Archaeoskin Map
Mythrite Rivets	Loot	Timeworn Archaeoskin Map
Mythrite Ingot	Loot	Timeworn Archaeoskin Map
Titanium Nugget	Loot	Timeworn Archaeoskin Map
Titanium Rivets	Loot	Timeworn Archaeoskin Map
Wyvern Leather	Loot	Timeworn Archaeoskin Map
Dhalmel Leather	Loot	Timeworn Archaeoskin Map
Rainbow Thread	Loot	Timeworn Archaeoskin Map
Holy Rainbow Cloth	Loot	Timeworn Archaeoskin Map
Ramie Thread	Loot	Timeworn Archaeoskin Map
Ramie Cloth	Loot	Timeworn Archaeoskin Map
Growth Formula Epsilon	Loot	Timeworn Archaeoskin Map
Holy Water	Loot	Timeworn Archaeoskin Map
Enchanted Hardsilver Ink	Loot	Timeworn Archaeoskin Map
Draconian Potion of Strength	Loot	Timeworn Archaeoskin Map	Timeworn Wyvernskin Map	Timeworn Dragonskin Map
Draconian Potion of Dexterity	Loot	Timeworn Archaeoskin Map	Timeworn Wyvernskin Map	Timeworn Dragonskin Map
Draconian Potion of Vitality	Loot	Timeworn Archaeoskin Map	Timeworn Wyvernskin Map	Timeworn Dragonskin Map
Draconian Potion of Intelligence	Loot	Timeworn Archaeoskin Map	Timeworn Wyvernskin Map	Timeworn Dragonskin Map
Draconian Potion of Mind	Loot	Timeworn Archaeoskin Map	Timeworn Wyvernskin Map	Timeworn Dragonskin Map
Antique Leather	Loot	Timeworn Wyvernskin Map
Antique Rug	Loot	Timeworn Wyvernskin Map
Atomos Corpulence	Loot	Timeworn Wyvernskin Map
Falconer's Hemp	Loot	Timeworn Wyvernskin Map
Steel Wheel Bearing	Loot	Timeworn Wyvernskin Map
Unidentifiable Ore	Loot	Timeworn Wyvernskin Map	Timeworn Dragonskin Map
Unidentifiable Shell	Loot	Timeworn Wyvernskin Map	Timeworn Dragonskin Map
Calamity Unbound Orchestrion Roll	Loot	Timeworn Wyvernskin Map
On Windy Meadows Orchestrion Roll	Loot	Timeworn Wyvernskin Map
Twilight over Thanalan Orchestrion Roll	Loot	Timeworn Wyvernskin Map
Dragon Fang	Loot	Timeworn Wyvernskin Map
Birch Lumber	Loot	Timeworn Wyvernskin Map
Hallowed Chestnut Lumber	Loot	Timeworn Wyvernskin Map
Adamantite Nugget	Loot	Timeworn Wyvernskin Map
Adamantite Rivets	Loot	Timeworn Wyvernskin Map
Hardsilver Ingot	Loot	Timeworn Wyvernskin Map
Dragon Leather	Loot	Timeworn Wyvernskin Map
Hallowed Ramie Cloth	Loot	Timeworn Wyvernskin Map
Crawler Silk	Loot	Timeworn Wyvernskin Map
Chimerical Felt	Loot	Timeworn Wyvernskin Map
Hallowed Water	Loot	Timeworn Wyvernskin Map
Growth Formula Zeta	Loot	Timeworn Wyvernskin Map
Paissa Brat	Loot	Timeworn Dragonskin Map
Thavnairian Leather	Loot	Timeworn Dragonskin Map
Thavnairian Silk	Loot	Timeworn Dragonskin Map
Holy Linen	Loot	Timeworn Gaganaskin Map
Leather Cointe Quaint	Loot	Timeworn Gaganaskin Map
Nagxian Leather	Loot	Timeworn Gaganaskin Map
Taoist's Wool	Loot	Timeworn Gaganaskin Map
Autumnal Ginkgo Tree	Loot	Timeworn Gaganaskin Map	Timeworn Gazelleskin Map
Autumnal Maple Tree	Loot	Timeworn Gaganaskin Map	Timeworn Gazelleskin Map
Ginkgo Leaf Pile	Loot	Timeworn Gaganaskin Map	Timeworn Gazelleskin Map
Maple Leaf Pile	Loot	Timeworn Gaganaskin Map	Timeworn Gazelleskin Map
Stygian Ash	Loot	Timeworn Gaganaskin Map	Timeworn Gazelleskin Map
Little Chef's Playset	Loot	Timeworn Gaganaskin Map	Fête Present
Plush Pile	Loot	Timeworn Gaganaskin Map
Unmoving Maneki Moogle	Loot	Timeworn Gaganaskin Map
Dzo Horn	Loot	Timeworn Gaganaskin Map
Muud Suud Horn	Loot	Timeworn Gaganaskin Map
Beech Lumber	Loot	Timeworn Gaganaskin Map
Larch Lumber	Loot	Timeworn Gaganaskin Map
Pine Lumber	Loot	Timeworn Gaganaskin Map
High Steel Nugget	Loot	Timeworn Gaganaskin Map
High Steel Ingot	Loot	Timeworn Gaganaskin Map
Oroshigane Ingot	Loot	Timeworn Gaganaskin Map
Tama-hagane Ingot	Loot	Timeworn Gaganaskin Map
Koppranickel Nugget	Loot	Timeworn Gaganaskin Map
Triphane	Loot	Timeworn Gaganaskin Map
Slate Whetstone	Loot	Timeworn Gaganaskin Map
Kyanite	Loot	Timeworn Gaganaskin Map
Gagana Leather	Loot	Timeworn Gaganaskin Map
Gyuki Leather	Loot	Timeworn Gaganaskin Map
Bloodhempen Yarn	Loot	Timeworn Gaganaskin Map
Ruby Cotton Yarn	Loot	Timeworn Gaganaskin Map
Kudzu Thread	Loot	Timeworn Gaganaskin Map
Worsted Yarn	Loot	Timeworn Gaganaskin Map
Commanding Craftsman's Tea	Loot	Timeworn Gaganaskin Map
Competent Craftsman's Tea	Loot	Timeworn Gaganaskin Map
Cunning Craftsman's Tea	Loot	Timeworn Gaganaskin Map
Enchanted Koppranickel Ink	Loot	Timeworn Gaganaskin Map
Enchanted Durium Ink	Loot	Timeworn Gaganaskin Map
Grade 1 Reisui of Strength	Loot	Timeworn Gaganaskin Map
Grade 1 Reisui of Dexterity	Loot	Timeworn Gaganaskin Map
Grade 1 Reisui of Vitality	Loot	Timeworn Gaganaskin Map
Grade 1 Reisui of Intelligence	Loot	Timeworn Gaganaskin Map
Grade 1 Reisui of Mind	Loot	Timeworn Gaganaskin Map
Growth Formula Eta	Loot	Timeworn Gaganaskin Map
Moai Statue	Loot	Timeworn Gazelleskin Map
Waterproof Cloth	Loot	Timeworn Gazelleskin Map
Fine Glass Fiber	Loot	Timeworn Gliderskin Map
Steer Hide	Loot	Timeworn Gliderskin Map
Calf Leather	Loot	Timeworn Zonureskin Map
Cloth-softening Powder	Loot	Timeworn Zonureskin Map
Fireglass Leather	Loot	Timeworn Zonureskin Map
Indigo Cloth	Loot	Timeworn Zonureskin Map
Seacloth	Loot	Timeworn Zonureskin Map
Shell Leather	Loot	Timeworn Zonureskin Map
Retainer Fantasia	Loot	Venture Coffer
General-purpose Pure White Dye	Loot	Venture Coffer	Silver-trimmed Sack	Gold-haloed Sack	Southern Front Lockbox	Fête Present	Zadnor Lockbox
General-purpose Jet Black Dye	Loot	Venture Coffer	Silver-trimmed Sack	Gold-haloed Sack	Southern Front Lockbox	Fête Present	Zadnor Lockbox
General-purpose Pastel Pink Dye	Loot	Venture Coffer	Silver-trimmed Sack	Gold-haloed Sack	Southern Front Lockbox	Fête Present	Zadnor Lockbox
General-purpose Dark Red Dye	Loot	Venture Coffer	Silver-trimmed Sack	Gold-haloed Sack	Southern Front Lockbox	Fête Present	Zadnor Lockbox
General-purpose Dark Brown Dye	Loot	Venture Coffer	Silver-trimmed Sack	Gold-haloed Sack	Southern Front Lockbox	Fête Present	Zadnor Lockbox
General-purpose Pastel Green Dye	Loot	Venture Coffer	Silver-trimmed Sack	Gold-haloed Sack	Southern Front Lockbox	Fête Present	Zadnor Lockbox
General-purpose Dark Green Dye	Loot	Venture Coffer	Silver-trimmed Sack	Gold-haloed Sack	Southern Front Lockbox	Fête Present	Zadnor Lockbox
General-purpose Pastel Blue Dye	Loot	Venture Coffer	Silver-trimmed Sack	Gold-haloed Sack	Southern Front Lockbox	Fête Present	Zadnor Lockbox
General-purpose Dark Blue Dye	Loot	Venture Coffer	Silver-trimmed Sack	Gold-haloed Sack	Southern Front Lockbox	Fête Present	Zadnor Lockbox
General-purpose Pastel Purple Dye	Loot	Venture Coffer	Silver-trimmed Sack	Gold-haloed Sack	Southern Front Lockbox	Fête Present	Zadnor Lockbox
General-purpose Dark Purple Dye	Loot	Venture Coffer	Silver-trimmed Sack	Gold-haloed Sack	Southern Front Lockbox	Fête Present	Zadnor Lockbox
General-purpose Metallic Silver Dye	Loot	Venture Coffer	Silver-trimmed Sack	Gold-haloed Sack	Southern Front Lockbox	Fête Present	Zadnor Lockbox
General-purpose Metallic Gold Dye	Loot	Venture Coffer	Silver-trimmed Sack	Gold-haloed Sack	Southern Front Lockbox	Fête Present	Zadnor Lockbox
General-purpose Metallic Red Dye	Loot	Venture Coffer	Silver-trimmed Sack	Gold-haloed Sack	Southern Front Lockbox	Fête Present	Zadnor Lockbox
General-purpose Metallic Orange Dye	Loot	Venture Coffer	Silver-trimmed Sack	Gold-haloed Sack	Southern Front Lockbox	Fête Present	Zadnor Lockbox
General-purpose Metallic Yellow Dye	Loot	Venture Coffer	Silver-trimmed Sack	Gold-haloed Sack	Southern Front Lockbox	Fête Present	Zadnor Lockbox
General-purpose Metallic Green Dye	Loot	Venture Coffer	Silver-trimmed Sack	Gold-haloed Sack	Southern Front Lockbox	Fête Present	Zadnor Lockbox
General-purpose Metallic Sky Blue Dye	Loot	Venture Coffer	Silver-trimmed Sack	Gold-haloed Sack	Southern Front Lockbox	Fête Present	Zadnor Lockbox
General-purpose Metallic Blue Dye	Loot	Venture Coffer	Silver-trimmed Sack	Gold-haloed Sack	Southern Front Lockbox	Fête Present	Zadnor Lockbox
General-purpose Metallic Purple Dye	Loot	Venture Coffer	Silver-trimmed Sack	Gold-haloed Sack	Southern Front Lockbox	Fête Present	Zadnor Lockbox
Allagan Platinum Piece	Loot	Bronze-trimmed Sack	Iron-trimmed Sack	Anemos Lockbox	Pagos Lockbox	Pyros Lockbox	Hydatos Lockbox
Baby Opo-opo	Loot	Bronze-trimmed Sack
Bluebird	Loot	Bronze-trimmed Sack
Cherry Confetti	Loot	Bronze-trimmed Sack	Iron-trimmed Sack	Anemos Lockbox	Pagos Lockbox
Peach Confetti	Loot	Bronze-trimmed Sack	Iron-trimmed Sack	Silver-haloed Sack	Gold-haloed Sack
Clear Demimateria I	Loot	Bronze-trimmed Sack	Silver-haloed Sack	Anemos Lockbox	Pagos Lockbox	Pyros Lockbox	Hydatos Lockbox
Clear Demimateria II	Loot	Bronze-trimmed Sack	Iron-trimmed Sack	Silver-haloed Sack	Anemos Lockbox	Pagos Lockbox	Pyros Lockbox	Hydatos Lockbox
Clear Demimateria III	Loot	Bronze-trimmed Sack	Iron-trimmed Sack	Silver-haloed Sack	Anemos Lockbox	Pagos Lockbox	Pyros Lockbox	Hydatos Lockbox
Savage Aim Materia IV	Loot	Bronze-trimmed Sack	Iron-trimmed Sack
Savage Aim Materia V	Loot	Bronze-trimmed Sack	Iron-trimmed Sack	Anemos Lockbox	Pagos Lockbox	Pyros Lockbox	Hydatos Lockbox
Savage Might Materia IV	Loot	Bronze-trimmed Sack	Iron-trimmed Sack
Savage Might Materia V	Loot	Bronze-trimmed Sack	Iron-trimmed Sack	Anemos Lockbox	Pagos Lockbox	Pyros Lockbox	Hydatos Lockbox
Heavens' Eye Materia IV	Loot	Bronze-trimmed Sack	Iron-trimmed Sack
Heavens' Eye Materia V	Loot	Bronze-trimmed Sack	Iron-trimmed Sack	Anemos Lockbox	Pagos Lockbox	Pyros Lockbox	Hydatos Lockbox
Quickarm Materia IV	Loot	Bronze-trimmed Sack	Iron-trimmed Sack
Quickarm Materia V	Loot	Bronze-trimmed Sack	Iron-trimmed Sack	Anemos Lockbox	Pagos Lockbox	Pyros Lockbox	Hydatos Lockbox
Quicktongue Materia IV	Loot	Bronze-trimmed Sack	Iron-trimmed Sack
Quicktongue Materia V	Loot	Bronze-trimmed Sack	Iron-trimmed Sack	Anemos Lockbox	Pagos Lockbox	Pyros Lockbox	Hydatos Lockbox
Battledance Materia IV	Loot	Bronze-trimmed Sack	Iron-trimmed Sack
Battledance Materia V	Loot	Bronze-trimmed Sack	Iron-trimmed Sack	Silver-haloed Sack	Anemos Lockbox	Pagos Lockbox	Pyros Lockbox	Hydatos Lockbox
Piety Materia IV	Loot	Bronze-trimmed Sack	Iron-trimmed Sack
Piety Materia V	Loot	Bronze-trimmed Sack	Iron-trimmed Sack	Anemos Lockbox	Pagos Lockbox	Pyros Lockbox	Hydatos Lockbox
Expeditioner's Coat	Loot	Bronze-trimmed Sack	Iron-trimmed Sack
Expeditioner's Moccasins	Loot	Bronze-trimmed Sack
Expeditioner's Pantalettes	Loot	Bronze-trimmed Sack
Falconer's Shirt	Loot	Bronze-trimmed Sack
Flame Tracer	Loot	Bronze-trimmed Sack	Iron-trimmed Sack	Anemos Lockbox
Serpent Tracer	Loot	Bronze-trimmed Sack	Iron-trimmed Sack	Anemos Lockbox
Storm Tracer	Loot	Bronze-trimmed Sack	Iron-trimmed Sack	Anemos Lockbox
Gaelikitten	Loot	Bronze-trimmed Sack
Gridanian Sparkler	Loot	Bronze-trimmed Sack	Iron-trimmed Sack	Silver-trimmed Sack	Silver-haloed Sack	Anemos Lockbox
Lominsan Sparkler	Loot	Bronze-trimmed Sack	Iron-trimmed Sack	Silver-trimmed Sack	Silver-haloed Sack	Anemos Lockbox
Ul'dahn Sparkler	Loot	Bronze-trimmed Sack	Iron-trimmed Sack	Silver-trimmed Sack	Silver-haloed Sack	Anemos Lockbox
Gryphonskin Breastguard	Loot	Bronze-trimmed Sack
Gryphonskin Pantalettes	Loot	Bronze-trimmed Sack
High House Boots	Loot	Bronze-trimmed Sack
High House Bustle	Loot	Bronze-trimmed Sack
High House Halfboots	Loot	Bronze-trimmed Sack
High House Justaucorps	Loot	Bronze-trimmed Sack
Lesser Panda	Loot	Bronze-trimmed Sack
Magicked Prism (Crimson Star)	Loot	Bronze-trimmed Sack	Iron-trimmed Sack	Silver-trimmed Sack	Anemos Lockbox
Magicked Prism (Emerald Star)	Loot	Bronze-trimmed Sack	Iron-trimmed Sack	Silver-trimmed Sack	Anemos Lockbox
Magicked Prism (Harbor Herald)	Loot	Bronze-trimmed Sack	Iron-trimmed Sack	Silver-trimmed Sack	Anemos Lockbox
Magicked Prism (Immortal Flames)	Loot	Bronze-trimmed Sack	Iron-trimmed Sack	Silver-trimmed Sack	Anemos Lockbox
Magicked Prism (Indigo Star)	Loot	Bronze-trimmed Sack	Iron-trimmed Sack	Silver-trimmed Sack	Anemos Lockbox	Southern Front Lockbox	Zadnor Lockbox
Magicked Prism (Maelstrom)	Loot	Bronze-trimmed Sack	Iron-trimmed Sack	Silver-trimmed Sack	Anemos Lockbox
Magicked Prism (Mythril Eye)	Loot	Bronze-trimmed Sack	Iron-trimmed Sack	Silver-trimmed Sack	Anemos Lockbox
Magicked Prism (The Raven)	Loot	Bronze-trimmed Sack	Iron-trimmed Sack	Silver-trimmed Sack	Anemos Lockbox
Magicked Prism (Twin Adder)	Loot	Bronze-trimmed Sack	Iron-trimmed Sack	Silver-trimmed Sack	Anemos Lockbox
Minute Mindflayer	Loot	Bronze-trimmed Sack
Modern Aesthetics - Samsonian Locks	Loot	Bronze-trimmed Sack	Iron-trimmed Sack	Silver-trimmed Sack
Moonfire Caligae	Loot	Bronze-trimmed Sack	Iron-trimmed Sack
Moonfire Halter	Loot	Bronze-trimmed Sack	Iron-trimmed Sack
Moonfire Hat	Loot	Bronze-trimmed Sack	Iron-trimmed Sack
Moonfire Tanga	Loot	Bronze-trimmed Sack	Iron-trimmed Sack
Mummy's Little Mummy	Loot	Bronze-trimmed Sack
Nutkin	Loot	Bronze-trimmed Sack
Page 63	Loot	Bronze-trimmed Sack
Paissa Brat	Loot	Bronze-trimmed Sack
Palace of the Dead Flooring	Loot	Bronze-trimmed Sack
Palace of the Dead Interior Wall	Loot	Bronze-trimmed Sack
Palace Pedestal	Loot	Bronze-trimmed Sack
Survival Boots	Loot	Bronze-trimmed Sack	Iron-trimmed Sack
Survival Halfslops	Loot	Bronze-trimmed Sack	Iron-trimmed Sack
Survival Hat	Loot	Bronze-trimmed Sack	Iron-trimmed Sack
Survival Shirt	Loot	Bronze-trimmed Sack	Iron-trimmed Sack
Thavnairian Armlets	Loot	Bronze-trimmed Sack
Thavnairian Babouches	Loot	Bronze-trimmed Sack
Thavnairian Bolero	Loot	Bronze-trimmed Sack
Thavnairian Bustier	Loot	Bronze-trimmed Sack
Thavnairian Headdress	Loot	Bronze-trimmed Sack
Thavnairian Sandals	Loot	Bronze-trimmed Sack
Thavnairian Sarouel	Loot	Bronze-trimmed Sack
Thavnairian Tights	Loot	Bronze-trimmed Sack
Tiny Bulb	Loot	Bronze-trimmed Sack
Ugly Duckling	Loot	Bronze-trimmed Sack
Unicolt	Loot	Bronze-trimmed Sack
Wind Silk Bottoms	Loot	Bronze-trimmed Sack	Iron-trimmed Sack
Wind Silk Coatee	Loot	Bronze-trimmed Sack
Wind-up Tonberry	Loot	Bronze-trimmed Sack
Blackbosom Orchestrion Roll	Loot	Iron-trimmed Sack	Silver-trimmed Sack
Dinosaur Leather Gloves	Loot	Iron-trimmed Sack
Dinosaur Leather Shoes	Loot	Iron-trimmed Sack
Expeditioner's Cap	Loot	Iron-trimmed Sack
Expeditioner's Gloves	Loot	Iron-trimmed Sack
Expeditioner's Moccasins	Loot	Iron-trimmed Sack
Expeditioner's Tabard	Loot	Iron-trimmed Sack
Expeditioner's Thighboots	Loot	Iron-trimmed Sack
Gryphonskin Breastguard	Loot	Iron-trimmed Sack
Moonfire Trunks	Loot	Iron-trimmed Sack
Moonfire Vest	Loot	Iron-trimmed Sack
Replica Allagan Boots of Casting	Loot	Iron-trimmed Sack
Replica Allagan Boots of Healing	Loot	Iron-trimmed Sack
Replica Allagan Breeches of Casting	Loot	Iron-trimmed Sack
Replica Allagan Breeches of Healing	Loot	Iron-trimmed Sack
Replica Allagan Circlet of Casting	Loot	Iron-trimmed Sack
Replica Allagan Circlet of Healing	Loot	Iron-trimmed Sack
Replica Allagan Cuirass of Aiming	Loot	Iron-trimmed Sack
Replica Allagan Cuirass of Maiming	Loot	Iron-trimmed Sack
Replica Allagan Cuirass of Striking	Loot	Iron-trimmed Sack
Replica Allagan Gauntlets of Aiming	Loot	Iron-trimmed Sack
Replica Allagan Gauntlets of Maiming	Loot	Iron-trimmed Sack
Replica Allagan Gauntlets of Striking	Loot	Iron-trimmed Sack
Replica Allagan Gloves of Casting	Loot	Iron-trimmed Sack
Replica Allagan Gloves of Healing	Loot	Iron-trimmed Sack
Replica Allagan Helm	Loot	Iron-trimmed Sack
Replica Allagan Sollerets of Aiming	Loot	Iron-trimmed Sack
Replica Allagan Sollerets of Maiming	Loot	Iron-trimmed Sack
Replica Allagan Sollerets of Striking	Loot	Iron-trimmed Sack
Replica Allagan Trousers of Aiming	Loot	Iron-trimmed Sack
Replica Allagan Trousers of Maiming	Loot	Iron-trimmed Sack
Replica Allagan Trousers of Striking	Loot	Iron-trimmed Sack
Replica Allagan Tunic of Casting	Loot	Iron-trimmed Sack
Replica Allagan Tunic of Healing	Loot	Iron-trimmed Sack
Replica Allagan Visor of Aiming	Loot	Iron-trimmed Sack
Replica Allagan Visor of Maiming	Loot	Iron-trimmed Sack
Replica Allagan Visor of Striking	Loot	Iron-trimmed Sack
Replica Heavy Allagan Armor	Loot	Iron-trimmed Sack
Replica Heavy Allagan Cuisses	Loot	Iron-trimmed Sack
Replica Heavy Allagan Sollerets	Loot	Iron-trimmed Sack
Replica Heavy Allagan Gauntlets	Loot	Iron-trimmed Sack
Uraeus Body Armor	Loot	Iron-trimmed Sack
Wind Silk Wedge Cap	Loot	Iron-trimmed Sack
Wind-up Edda	Loot	Iron-trimmed Sack	Silver-trimmed Sack	Gold-trimmed Sack
Abigail Barding	Loot	Silver-trimmed Sack	Gold-trimmed Sack
Inferno Blade	Loot	Silver-trimmed Sack
Inferno Claws	Loot	Silver-trimmed Sack
Inferno Battleaxe	Loot	Silver-trimmed Sack
Inferno Harpoon	Loot	Silver-trimmed Sack
Inferno Bow	Loot	Silver-trimmed Sack
Inferno Cane	Loot	Silver-trimmed Sack
Inferno Cudgel	Loot	Silver-trimmed Sack
Inferno Grimoire	Loot	Silver-trimmed Sack
Inferno Codex	Loot	Silver-trimmed Sack
Inferno Kris	Loot	Silver-trimmed Sack
Inferno Faussar	Loot	Silver-trimmed Sack
Inferno Musketoon	Loot	Silver-trimmed Sack
Inferno Star Globe	Loot	Silver-trimmed Sack
Inferno Rod	Loot	Silver-trimmed Sack
Inferno Katana	Loot	Silver-trimmed Sack
Inferno Rapier	Loot	Silver-trimmed Sack
Replica Allagan Baghnakhs	Loot	Silver-trimmed Sack
Replica Allagan Battleaxe	Loot	Silver-trimmed Sack
Replica Allagan Blade	Loot	Silver-trimmed Sack
Replica Allagan Cane	Loot	Silver-trimmed Sack
Replica Allagan Composite Bow	Loot	Silver-trimmed Sack
Replica Allagan Daggers	Loot	Silver-trimmed Sack
Replica Allagan Grimoire of Casting	Loot	Silver-trimmed Sack
Replica Allagan Grimoire of Healing	Loot	Silver-trimmed Sack
Replica Allagan Guillotine	Loot	Silver-trimmed Sack
Replica Allagan Pistol	Loot	Silver-trimmed Sack
Replica Allagan Rod	Loot	Silver-trimmed Sack
Replica Allagan Round Shield	Loot	Silver-trimmed Sack
Replica Allagan Scepter	Loot	Silver-trimmed Sack
Replica Allagan Spear	Loot	Silver-trimmed Sack
Replica Allagan Star Globe	Loot	Silver-trimmed Sack
Replica High Allagan Trousers of Fending	Loot	Silver-trimmed Sack
Replica High Allagan Sabatons of Maiming	Loot	Silver-trimmed Sack
Replica High Allagan Headgear of Striking	Loot	Silver-trimmed Sack
Replica High Allagan Gauntlets of Striking	Loot	Silver-trimmed Sack
Replica High Allagan Sabatons of Striking	Loot	Silver-trimmed Sack
The Greater Key of Tremors	Loot	Silver-trimmed Sack
The Holy Key of Tremors	Loot	Silver-trimmed Sack
Tremor Axe	Loot	Silver-trimmed Sack
Tremor Bow	Loot	Silver-trimmed Sack
Tremor Cane	Loot	Silver-trimmed Sack
Tremor Cleavers	Loot	Silver-trimmed Sack
Tremor Cudgel	Loot	Silver-trimmed Sack
Tremor Culverin	Loot	Silver-trimmed Sack
Tremor Foil	Loot	Silver-trimmed Sack
Tremor Guillotine	Loot	Silver-trimmed Sack
Tremor Katana	Loot	Silver-trimmed Sack
Tremor Knuckles	Loot	Silver-trimmed Sack
Tremor Shield	Loot	Silver-trimmed Sack
Tremor Spear	Loot	Silver-trimmed Sack
Tremor Staff	Loot	Silver-trimmed Sack
Tremor Star Globe	Loot	Silver-trimmed Sack
Abandon of the Vortex	Loot	Silver-trimmed Sack
Beak of the Vortex	Loot	Silver-trimmed Sack
Blood of the Vortex	Loot	Silver-trimmed Sack
Gaze of the Vortex	Loot	Silver-trimmed Sack
Heart of the Vortex	Loot	Silver-trimmed Sack
Honor of the Vortex	Loot	Silver-trimmed Sack
Lift of the Vortex	Loot	Silver-trimmed Sack
Spine of the Vortex	Loot	Silver-trimmed Sack
Pain of the Vortex	Loot	Silver-trimmed Sack
Plumes of the Vortex	Loot	Silver-trimmed Sack
Scream of the Vortex	Loot	Silver-trimmed Sack
Talons of the Vortex	Loot	Silver-trimmed Sack
Van of the Vortex	Loot	Silver-trimmed Sack
Wile of the Vortex	Loot	Silver-trimmed Sack
Will of the Vortex	Loot	Silver-trimmed Sack
Dead Hive Battleaxe	Loot	Gold-trimmed Sack
Dead Hive Bow	Loot	Gold-trimmed Sack
Dead Hive Cane	Loot	Gold-trimmed Sack
Dead Hive Claws	Loot	Gold-trimmed Sack
Dead Hive Claymore	Loot	Gold-trimmed Sack
Dead Hive Codex	Loot	Gold-trimmed Sack
Dead Hive Grimoire	Loot	Gold-trimmed Sack
Dead Hive Kris	Loot	Gold-trimmed Sack
Dead Hive Longpole	Loot	Gold-trimmed Sack
Dead Hive Musketoon	Loot	Gold-trimmed Sack
Dead Hive Planisphere	Loot	Gold-trimmed Sack
Dead Hive Shamshir	Loot	Gold-trimmed Sack
Dead Hive Spear	Loot	Gold-trimmed Sack
Endless Expanse Astrometer	Loot	Gold-trimmed Sack
Endless Expanse Battleaxe	Loot	Gold-trimmed Sack
Endless Expanse Cane	Loot	Gold-trimmed Sack
Endless Expanse Codex	Loot	Gold-trimmed Sack
Endless Expanse Greatsword	Loot	Gold-trimmed Sack
Endless Expanse Grimoire	Loot	Gold-trimmed Sack
Endless Expanse Handgonne	Loot	Gold-trimmed Sack
Endless Expanse Longbow	Loot	Gold-trimmed Sack
Endless Expanse Longpole	Loot	Gold-trimmed Sack
Endless Expanse Machetes	Loot	Gold-trimmed Sack
Endless Expanse Partisan	Loot	Gold-trimmed Sack
Endless Expanse Patas	Loot	Gold-trimmed Sack
Endless Expanse Sword	Loot	Gold-trimmed Sack
High Adjudicator's Gavel	Loot	Gold-trimmed Sack
High Adjudicator's Staff	Loot	Gold-trimmed Sack
Majestic Moggle Mogtome	Loot	Gold-trimmed Sack
Maleficent Moggle Mogstaff	Loot	Gold-trimmed Sack
Malevolent Moggle Mogwand	Loot	Gold-trimmed Sack
Malignant Moggle Mogaxe	Loot	Gold-trimmed Sack
Melancholy Moggle Mogfork	Loot	Gold-trimmed Sack
Menacing Moggle Mog Gun	Loot	Gold-trimmed Sack
Mighty Moggle Mogrod	Loot	Gold-trimmed Sack
Mighty Thunderbolt	Loot	Gold-trimmed Sack
Mighty Thunderclap	Loot	Gold-trimmed Sack
Mighty Thundercrack	Loot	Gold-trimmed Sack
Mighty Thunderdart	Loot	Gold-trimmed Sack
Mighty Thunderdome	Loot	Gold-trimmed Sack
Mighty Thunderhead	Loot	Gold-trimmed Sack
Mighty Thundershower	Loot	Gold-trimmed Sack
Mighty Thundersparks	Loot	Gold-trimmed Sack
Mighty Thunderstorm	Loot	Gold-trimmed Sack
Mighty Thunderstrike	Loot	Gold-trimmed Sack
Mischievous Moggle Mogbow	Loot	Gold-trimmed Sack
Monstrous Moggle Mogsword	Loot	Gold-trimmed Sack
Moonlit Moggle Moglobe	Loot	Gold-trimmed Sack
Morbid Moggle Mogblade	Loot	Gold-trimmed Sack
Mortal Moggle Mogknives	Loot	Gold-trimmed Sack
Munificent Moggle Mogtome	Loot	Gold-trimmed Sack
Murderous Moggle Mogfists	Loot	Gold-trimmed Sack
Night Pegasus Whistle	Loot	Gold-trimmed Sack
Ona Ramuhda First Edition	Loot	Gold-trimmed Sack
Replica High Allagan Blade	Loot	Gold-trimmed Sack
The Law of Levin First Edition	Loot	Gold-trimmed Sack
Bombfish	Loot	Silver-haloed Sack
Baby Brachiosaur	Loot	Silver-haloed Sack
Black Cherry Blossom Corsage	Loot	Silver-haloed Sack
Blissful Barding	Loot	Silver-haloed Sack
Bom Boko	Loot	Silver-haloed Sack
Castaway Chocobo Chick	Loot	Silver-haloed Sack
Dried Green Oldrose	Loot	Silver-haloed Sack
Dwarf Rabbit	Loot	Silver-haloed Sack
Empyrean Clay	Loot	Silver-haloed Sack
Empyrean Pine Log	Loot	Silver-haloed Sack
Expanse Barding	Loot	Silver-haloed Sack
Falconer's Boots	Loot	Silver-haloed Sack
Falconer's Bottoms	Loot	Silver-haloed Sack
Falconer's Shirt	Loot	Silver-haloed Sack
Gestahl	Loot	Silver-haloed Sack
Ghido	Loot	Silver-haloed Sack
Hatamoto Card	Loot	Silver-haloed Sack	Gold-haloed Sack
Hive Barding	Loot	Silver-haloed Sack
Horde Barding	Loot	Silver-haloed Sack
Hunting Hawk	Loot	Silver-haloed Sack
Ice Barding	Loot	Silver-haloed Sack
Korpokkur Kid	Loot	Silver-haloed Sack
Levin Barding	Loot	Silver-haloed Sack
Miniature Minecart	Loot	Silver-haloed Sack
Modern Aesthetics - Gyr Abanian Plait	Loot	Silver-haloed Sack
Morpho	Loot	Silver-haloed Sack
Odder Otter	Loot	Silver-haloed Sack
Oldrose Corsage	Loot	Silver-haloed Sack
Parting Ways Orchestrion Roll	Loot	Silver-haloed Sack
Reveler's Barding	Loot	Silver-haloed Sack	Zadnor Lockbox
Road Sparrow	Loot	Silver-haloed Sack
Sephirotic Barding	Loot	Silver-haloed Sack
Shaggy Shoat	Loot	Silver-haloed Sack
Sophic Barding	Loot	Silver-haloed Sack
Thavnairian Armlets	Loot	Silver-haloed Sack
Thavnairian Bolero	Loot	Silver-haloed Sack
Thavnairian Headdress	Loot	Silver-haloed Sack
Thavnairian Tights	Loot	Silver-haloed Sack
Tidal Barding	Loot	Silver-haloed Sack
Wanyudo & Katasharin Card	Loot	Silver-haloed Sack	Gold-haloed Sack
Wind-up Lakshmi	Loot	Silver-haloed Sack
Wind-up Leviathan	Loot	Silver-haloed Sack
Wind-up Ramuh	Loot	Silver-haloed Sack
Wind-up Shiva	Loot	Silver-haloed Sack
Wind-up Susano	Loot	Silver-haloed Sack
Zurvanite Barding	Loot	Silver-haloed Sack
Ao Dai	Loot	Gold-haloed Sack
Bombfish	Loot	Gold-haloed Sack
Bibliophobia Orchestrion Roll	Loot	Gold-haloed Sack
Cropped Wool Slops	Loot	Gold-haloed Sack
Down the Up Staircase Orchestrion Roll	Loot	Gold-haloed Sack
Empyrean Clay	Loot	Gold-haloed Sack
Empyrean Pine Log	Loot	Gold-haloed Sack
Flannel Suspenders	Loot	Gold-haloed Sack
Ghido	Loot	Gold-haloed Sack
Hannish Wool	Loot	Gold-haloed Sack
Hiruko Card	Loot	Gold-haloed Sack
Hunting Hawk	Loot	Gold-haloed Sack
Imagination Orchestrion Roll	Loot	Gold-haloed Sack
Korpokkur Kid	Loot	Gold-haloed Sack
Morpho	Loot	Gold-haloed Sack
New World Headdress	Loot	Gold-haloed Sack
Odder Otter	Loot	Gold-haloed Sack
Oriental Rice Ball Lunch	Loot	Gold-haloed Sack
Quan	Loot	Gold-haloed Sack
Riptide Orchestrion Roll	Loot	Gold-haloed Sack
Thavnairian Wool	Loot	Gold-haloed Sack
The Dark's Embrace Orchestrion Roll	Loot	Gold-haloed Sack
Tiny Tatsunoko	Loot	Gold-haloed Sack
Unbreakable (Duality) Orchestrion Roll	Loot	Gold-haloed Sack
Wind-up Bismarck	Loot	Gold-haloed Sack
Wind-up Ifrit	Loot	Gold-haloed Sack	Platinum-haloed Sack
Wind-up Lakshmi	Loot	Gold-haloed Sack
Wind-up Ramuh	Loot	Gold-haloed Sack
Wind-up Shiva	Loot	Gold-haloed Sack
Wind-up Susano	Loot	Gold-haloed Sack	Platinum-haloed Sack
Wind-up Titan	Loot	Gold-haloed Sack
Astrometer of the Round	Loot	Platinum-haloed Sack
Axe of the Fiend	Loot	Platinum-haloed Sack
Axe of the Round	Loot	Platinum-haloed Sack
Blade of the Fiend	Loot	Platinum-haloed Sack
Bow of the Fiend	Loot	Platinum-haloed Sack
Bow of the Round	Loot	Platinum-haloed Sack
Cane of the Fiend	Loot	Platinum-haloed Sack
Cane of the Round	Loot	Platinum-haloed Sack
Claymore of the Round	Loot	Platinum-haloed Sack
Codex of the Round	Loot	Platinum-haloed Sack
Daggers of the Round	Loot	Platinum-haloed Sack
Dodo Horn	Loot	Platinum-haloed Sack
Edge of the Fiend	Loot	Platinum-haloed Sack
Fire of the Fiend	Loot	Platinum-haloed Sack
Fire of the Round	Loot	Platinum-haloed Sack
Fists of the Fiend	Loot	Platinum-haloed Sack
Grimoire of the Round	Loot	Platinum-haloed Sack
Halberd of the Round	Loot	Platinum-haloed Sack
Katana of the Fiend	Loot	Platinum-haloed Sack
Katana of the Round	Loot	Platinum-haloed Sack
Knuckles of the Round	Loot	Platinum-haloed Sack
Miniature Heaven-on-High	Loot	Platinum-haloed Sack
Pike of the Fiend	Loot	Platinum-haloed Sack
Points of the Fiend	Loot	Platinum-haloed Sack
Rapier of the Fiend	Loot	Platinum-haloed Sack
Rapier of the Round	Loot	Platinum-haloed Sack
Shield of the Fiend	Loot	Platinum-haloed Sack
Shield of the Round	Loot	Platinum-haloed Sack
Song of the Fiend	Loot	Platinum-haloed Sack
Staff of the Fiend	Loot	Platinum-haloed Sack
Staff of the Round	Loot	Platinum-haloed Sack
Star of the Fiend	Loot	Platinum-haloed Sack
Sword of the Round	Loot	Platinum-haloed Sack
The Open Box Orchestrion Roll	Loot	Platinum-haloed Sack
Word of the Fiend	Loot	Platinum-haloed Sack
Cracked Cluster	Loot	Anemos Lockbox	Pagos Lockbox
Eurekan Potion	Loot	Anemos Lockbox	Pagos Lockbox	Pyros Lockbox
Savage Aim Materia VI	Loot	Anemos Lockbox	Pagos Lockbox	Pyros Lockbox	Hydatos Lockbox
Savage Might Materia VI	Loot	Anemos Lockbox	Pagos Lockbox	Pyros Lockbox	Hydatos Lockbox
Heavens' Eye Materia VI	Loot	Anemos Lockbox	Pagos Lockbox	Pyros Lockbox	Hydatos Lockbox
Quickarm Materia VI	Loot	Anemos Lockbox	Pagos Lockbox	Pyros Lockbox	Hydatos Lockbox
Quicktongue Materia VI	Loot	Anemos Lockbox	Pagos Lockbox	Pyros Lockbox	Hydatos Lockbox
Battledance Materia VI	Loot	Anemos Lockbox	Pagos Lockbox	Pyros Lockbox	Hydatos Lockbox
Piety Materia VI	Loot	Anemos Lockbox	Pagos Lockbox	Pyros Lockbox	Hydatos Lockbox
Anemos Hat	Loot	Anemos Lockbox
Anemos Jacket	Loot	Anemos Lockbox
Anemos Gloves	Loot	Anemos Lockbox
Anemos Chaps	Loot	Anemos Lockbox
Anemos Boots	Loot	Anemos Lockbox
Anemos Pot Helm	Loot	Anemos Lockbox
Anemos Gambison	Loot	Anemos Lockbox
Anemos Expeditionary's Gloves	Loot	Anemos Lockbox
Anemos Sarouel	Loot	Anemos Lockbox
Anemos Expeditionary's Boots	Loot	Anemos Lockbox
Anemos Suspenders	Loot	Anemos Lockbox
Sharlayan Cabinet	Loot	Anemos Lockbox
Sharlayan Wardrobe	Loot	Anemos Lockbox
Wind-up Fafnir	Loot	Anemos Lockbox
Wind-up Mithra	Loot	Anemos Lockbox
The Prince of Anemos	Loot	Anemos Lockbox
Tyrannosaur Horn	Loot	Anemos Lockbox
Red Mage Barding	Loot	Anemos Lockbox
Wicked Winds Whisper Orchestrion Roll	Loot	Anemos Lockbox
No Quarter Orchestrion Roll	Loot	Anemos Lockbox
Protean Crystal	Loot	Anemos Crystal
Lizard Tail	Loot	Pagos Lockbox	Pyros Lockbox	Hydatos Lockbox
Reishi Mushroom	Loot	Pagos Lockbox	Pyros Lockbox	Hydatos Lockbox
Wind-up Tarutaru	Loot	Pagos Lockbox	Cold-warped Lockbox
Pagos Bandana	Loot	Pagos Lockbox
Pagos Bolero	Loot	Pagos Lockbox
Pagos Boots	Loot	Pagos Lockbox
Pagos Circlet	Loot	Pagos Lockbox
Pagos Culottes	Loot	Pagos Lockbox
Pagos Field Dressing	Loot	Pagos Lockbox
Pagos Gaskins	Loot	Pagos Lockbox
Pagos Gloves	Loot	Pagos Lockbox
Pagos Sandals	Loot	Pagos Lockbox
Pagos Shirt	Loot	Pagos Lockbox
Boutique Batiste	Loot	Pagos Lockbox
Boutique Boarded Leather	Loot	Pagos Lockbox
Crossed Halberds	Loot	Cold-warped Lockbox
Golden Hakutaku Eye	Loot	Cold-warped Lockbox
Chainmail Hanger	Loot	Cold-warped Lockbox
Ballroom Etiquette - Insufficient Petticoats	Loot	Cold-warped Lockbox
Pagos Sage	Loot	Pyros Lockbox	Hydatos Lockbox	Pagos Lockbox
Pagos Spring Water	Loot	Pyros Lockbox	Hydatos Lockbox	Pagos Lockbox
Adventuring Pack	Loot	Pyros Lockbox
Glass Jars	Loot	Pyros Lockbox
Spice Rack	Loot	Pyros Lockbox
Wooden Plates	Loot	Pyros Lockbox
Wooden Cups	Loot	Pyros Lockbox
Dhalmel Calf	Loot	Pyros Lockbox	Heat-warped Lockbox
Ballroom Etiquette - Ideal Gossip	Loot	Heat-warped Lockbox
Samurai Barding	Loot	Heat-warped Lockbox
Tactical Logogram	Loot	Heat-warped Lockbox	Moisture-warped Lockbox
Gates of Paradise - The Garden of Ru'Hmet Orchestrion Roll	Loot	Hydatos Lockbox
Paissa Chronometer	Loot	Hydatos Lockbox
Simple Treehouse	Loot	Hydatos Lockbox
Yukinko Snowflake	Loot	Hydatos Lockbox	Moisture-warped Lockbox
Sharlayan Aether Oil	Loot	Moisture-warped Lockbox
Ballroom Etiquette - Overzealous Affirmations	Loot	Moisture-warped Lockbox
Onslaught Orchestrion Roll	Loot	Moisture-warped Lockbox
Savage Aim Materia VII	Loot	Southern Front Lockbox	Zadnor Lockbox
Savage Aim Materia VIII	Loot	Southern Front Lockbox	Zadnor Lockbox
Savage Might Materia VII	Loot	Southern Front Lockbox	Zadnor Lockbox
Savage Might Materia VIII	Loot	Southern Front Lockbox	Zadnor Lockbox
Heavens' Eye Materia VII	Loot	Southern Front Lockbox	Zadnor Lockbox
Heavens' Eye Materia VIII	Loot	Southern Front Lockbox	Zadnor Lockbox
Quickarm Materia VII	Loot	Southern Front Lockbox	Zadnor Lockbox
Quickarm Materia VIII	Loot	Southern Front Lockbox	Zadnor Lockbox
Quicktongue Materia VII	Loot	Southern Front Lockbox	Zadnor Lockbox
Quicktongue Materia VIII	Loot	Southern Front Lockbox	Zadnor Lockbox
Battledance Materia VII	Loot	Southern Front Lockbox	Zadnor Lockbox
Battledance Materia VIII	Loot	Southern Front Lockbox	Zadnor Lockbox
Piety Materia VII	Loot	Southern Front Lockbox	Zadnor Lockbox
Piety Materia VIII	Loot	Southern Front Lockbox	Zadnor Lockbox
Seeing Horde Blade	Loot	Southern Front Lockbox
Seeing Horde Shield	Loot	Southern Front Lockbox
Seeing Horde Knuckles	Loot	Southern Front Lockbox
Seeing Horde Axe	Loot	Southern Front Lockbox
Seeing Horde Spear	Loot	Southern Front Lockbox
Seeing Horde Bow	Loot	Southern Front Lockbox
Seeing Horde Daggers	Loot	Southern Front Lockbox
Seeing Horde Guillotine	Loot	Southern Front Lockbox
Seeing Horde Handgonne	Loot	Southern Front Lockbox
Seeing Horde Cane	Loot	Southern Front Lockbox
Seeing Horde Rod	Loot	Southern Front Lockbox
Seeing Horde Grimoire	Loot	Southern Front Lockbox
Seeing Horde Codex	Loot	Southern Front Lockbox
Seeing Horde Star Globe	Loot	Southern Front Lockbox
Seeing Horde Katana	Loot	Southern Front Lockbox
Seeing Horde Rapier	Loot	Southern Front Lockbox
Abroader Otter	Loot	Southern Front Lockbox	Zadnor Lockbox
Aurelia Polyp	Loot	Southern Front Lockbox	Zadnor Lockbox
Axolotl Eft	Loot	Southern Front Lockbox	Zadnor Lockbox
Byakko Cub	Loot	Southern Front Lockbox	Zadnor Lockbox
Dainsleif F1	Loot	Southern Front Lockbox
Koala Joey	Loot	Southern Front Lockbox	Zadnor Lockbox
Mameshiba	Loot	Southern Front Lockbox	Zadnor Lockbox
Monkey King	Loot	Southern Front Lockbox	Zadnor Lockbox
Mudpie	Loot	Southern Front Lockbox	Zadnor Lockbox
Private Moai	Loot	Southern Front Lockbox	Zadnor Lockbox
Salt & Pepper Seal	Loot	Southern Front Lockbox	Zadnor Lockbox
Scarlet Peacock	Loot	Southern Front Lockbox	Zadnor Lockbox
Seitei	Loot	Southern Front Lockbox	Zadnor Lockbox
Tengu Doll	Loot	Southern Front Lockbox
White Whittret	Loot	Southern Front Lockbox	Zadnor Lockbox
Wind-up Ravana	Loot	Southern Front Lockbox
Wind-up Shinryu	Loot	Southern Front Lockbox	Zadnor Lockbox
Wind-up Weapon	Loot	Southern Front Lockbox	Zadnor Lockbox
Byakko Barding	Loot	Southern Front Lockbox	Zadnor Lockbox
Lunar Barding	Loot	Southern Front Lockbox	Zadnor Lockbox
Seiryu Barding	Loot	Southern Front Lockbox
Shinryu Barding	Loot	Southern Front Lockbox
Suzaku Barding	Loot	Southern Front Lockbox
Red Brightlily Corsage	Loot	Southern Front Lockbox
Blue Brightlily Corsage	Loot	Southern Front Lockbox
Yellow Brightlily Corsage	Loot	Southern Front Lockbox
Green Brightlily Corsage	Loot	Southern Front Lockbox
Orange Brightlily Corsage	Loot	Southern Front Lockbox
Purple Brightlily Corsage	Loot	Southern Front Lockbox
White Brightlily Corsage	Loot	Southern Front Lockbox
Black Brightlily Corsage	Loot	Southern Front Lockbox
Rainbow Brightlily Corsage	Loot	Southern Front Lockbox
Red Daisy Corsage	Loot	Southern Front Lockbox
Blue Daisy Corsage	Loot	Southern Front Lockbox
Yellow Daisy Corsage	Loot	Southern Front Lockbox
Green Daisy Corsage	Loot	Southern Front Lockbox
Orange Daisy Corsage	Loot	Southern Front Lockbox
Purple Daisy Corsage	Loot	Southern Front Lockbox
White Daisy Corsage	Loot	Southern Front Lockbox
Black Daisy Corsage	Loot	Southern Front Lockbox
Rainbow Daisy Corsage	Loot	Southern Front Lockbox
Red Tulip Corsage	Loot	Southern Front Lockbox
Blue Tulip Corsage	Loot	Southern Front Lockbox
Yellow Tulip Corsage	Loot	Southern Front Lockbox
Green Tulip Corsage	Loot	Southern Front Lockbox
Orange Tulip Corsage	Loot	Southern Front Lockbox
Purple Tulip Corsage	Loot	Southern Front Lockbox
White Tulip Corsage	Loot	Southern Front Lockbox
Black Tulip Corsage	Loot	Southern Front Lockbox
Rainbow Tulip Corsage	Loot	Southern Front Lockbox
Red Viola Corsage	Loot	Southern Front Lockbox
Blue Viola Corsage	Loot	Southern Front Lockbox
Yellow Viola Corsage	Loot	Southern Front Lockbox
Green Viola Corsage	Loot	Southern Front Lockbox
Orange Viola Corsage	Loot	Southern Front Lockbox
Purple Viola Corsage	Loot	Southern Front Lockbox
White Viola Corsage	Loot	Southern Front Lockbox
Black Viola Corsage	Loot	Southern Front Lockbox
Rainbow Viola Corsage	Loot	Southern Front Lockbox
Hannish Wool Autumn Shirt	Loot	Southern Front Lockbox	Zadnor Lockbox
Quaintrelle's Hat	Loot	Southern Front Lockbox	Zadnor Lockbox
Quaintrelle's Ruffled Dress	Loot	Southern Front Lockbox	Zadnor Lockbox
Quaintrelle's Ruffled Skirt	Loot	Southern Front Lockbox	Zadnor Lockbox
Quaintrelle's Dress Shoes	Loot	Southern Front Lockbox	Zadnor Lockbox
Rain Hood	Loot	Southern Front Lockbox	Zadnor Lockbox
Raincoat	Loot	Southern Front Lockbox	Zadnor Lockbox
Rain Boots	Loot	Southern Front Lockbox	Zadnor Lockbox
Thavnairian Wool Autumn Dress	Loot	Southern Front Lockbox	Zadnor Lockbox
Thavnairian Wool Autumn Shirt	Loot	Southern Front Lockbox	Zadnor Lockbox
Blazing Inferno Wall Lamp	Loot	Southern Front Lockbox
Boundless Expanse Fountain	Loot	Southern Front Lockbox
Dainsleif SD	Loot	Southern Front Lockbox
Deep Hive Ceiling Fan	Loot	Southern Front Lockbox
Diamond Chandelier	Loot	Southern Front Lockbox
Helldiver SD	Loot	Southern Front Lockbox
Lord of Levin Lamp	Loot	Southern Front Lockbox
Nidhogg Miniature	Loot	Southern Front Lockbox
Raging Vortex Couch	Loot	Southern Front Lockbox
Sephirot Tree	Loot	Southern Front Lockbox
Sophia Miniature	Loot	Southern Front Lockbox
Titanic Cragsoul Lamp	Loot	Southern Front Lockbox
Zurvan Miniature	Loot	Southern Front Lockbox
Classy Checkered Parasol	Loot	Southern Front Lockbox
Gabriel α Identification Key	Loot	Southern Front Lockbox
Wind on the Plains Orchestrion Roll	Loot	Southern Front Lockbox
Ballroom Etiquette - Good Will Seeking	Loot	Zadnor Lockbox
Bozjan Barding	Loot	Zadnor Lockbox
Modern Aesthetics - Both Ways	Loot	Zadnor Lockbox
Sharksucker-class Insubmersible	Loot	Zadnor Lockbox
Blade of the Goddess	Loot	Zadnor Lockbox
Fists of the Goddess	Loot	Zadnor Lockbox
Axe of the Goddess	Loot	Zadnor Lockbox
Pike of the Goddess	Loot	Zadnor Lockbox
Bow of the Goddess	Loot	Zadnor Lockbox
Points of the Goddess	Loot	Zadnor Lockbox
Edge of the Goddess	Loot	Zadnor Lockbox
Fire of the Goddess	Loot	Zadnor Lockbox
Cane of the Goddess	Loot	Zadnor Lockbox
Pole of the Goddess	Loot	Zadnor Lockbox
Word of the Goddess	Loot	Zadnor Lockbox
Song of the Goddess	Loot	Zadnor Lockbox
Star of the Goddess	Loot	Zadnor Lockbox
Katana of the Goddess	Loot	Zadnor Lockbox
Rapier of the Goddess	Loot	Zadnor Lockbox
Shield of the Goddess	Loot	Zadnor Lockbox
Adventurer's Hooded Vest	Loot	Zadnor Lockbox
Adventuring Sweater	Loot	Zadnor Lockbox
Ala Mhigan Gown	Loot	Zadnor Lockbox
Hooded Fireglass Leather Vest	Loot	Zadnor Lockbox
Summer Indigo Shirt	Loot	Zadnor Lockbox
Cropped Summer Indigo Slops	Loot	Zadnor Lockbox
Steerhide Shoes	Loot	Zadnor Lockbox
Expanse Barding	Loot	Zadnor Lockbox
Horde Barding	Loot	Zadnor Lockbox
Reveler's Barding	Loot	Zadnor Lockbox
Sephirotic Barding	Loot	Zadnor Lockbox
Sophic Barding	Loot	Zadnor Lockbox
Zurvanite Barding	Loot	Zadnor Lockbox
Red Arum Corsage	Loot	Zadnor Lockbox
Blue Arum Corsage	Loot	Zadnor Lockbox
Yellow Arum Corsage	Loot	Zadnor Lockbox
Green Arum Corsage	Loot	Zadnor Lockbox
Orange Arum Corsage	Loot	Zadnor Lockbox
Purple Arum Corsage	Loot	Zadnor Lockbox
White Arum Corsage	Loot	Zadnor Lockbox
Black Arum Corsage	Loot	Zadnor Lockbox
Rainbow Arum Corsage	Loot	Zadnor Lockbox
Red Dahlia Corsage	Loot	Zadnor Lockbox
Blue Dahlia Corsage	Loot	Zadnor Lockbox
Yellow Dahlia Corsage	Loot	Zadnor Lockbox
Green Dahlia Corsage	Loot	Zadnor Lockbox
Orange Dahlia Corsage	Loot	Zadnor Lockbox
Purple Dahlia Corsage	Loot	Zadnor Lockbox
White Dahlia Corsage	Loot	Zadnor Lockbox
Black Dahlia Corsage	Loot	Zadnor Lockbox
Rainbow Dahlia Corsage	Loot	Zadnor Lockbox
Red Lily of the Valley Corsage	Loot	Zadnor Lockbox
Blue Lily of the Valley Corsage	Loot	Zadnor Lockbox
Yellow Lily of the Valley Corsage	Loot	Zadnor Lockbox
Green Lily of the Valley Corsage	Loot	Zadnor Lockbox
Orange Lily of the Valley Corsage	Loot	Zadnor Lockbox
Purple Lily of the Valley Corsage	Loot	Zadnor Lockbox
White Lily of the Valley Corsage	Loot	Zadnor Lockbox
Black Lily of the Valley Corsage	Loot	Zadnor Lockbox
Rainbow Lily of the Valley Corsage	Loot	Zadnor Lockbox
Byakko Sideboard	Loot	Zadnor Lockbox
Byakko Throne	Loot	Zadnor Lockbox
Seiryu Statuette	Loot	Zadnor Lockbox
Shinryu's Wing	Loot	Zadnor Lockbox
Stuffed Peerifool	Loot	Zadnor Lockbox
Stuffed Tsukuyomi	Loot	Zadnor Lockbox
Suzaku Wall Hanging	Loot	Zadnor Lockbox
Gunmetal Black Dye	Loot	Fête Present
Pearl White Dye	Loot	Fête Present
Metallic Brass Dye	Loot	Fête Present
Ruby Red Dye	Loot	Fête Present
Cherry Pink Dye	Loot	Fête Present
Canary Yellow Dye	Loot	Fête Present
Vanilla Yellow Dye	Loot	Fête Present
Dragoon Blue Dye	Loot	Fête Present
Turquoise Blue Dye	Loot	Fête Present
Fête Token	Loot	Fête Present
Antelope Stag Horn	Loot	Fête Present
Peacelover's Attire Coffer	Loot	Fête Present
Atrophied Atomos	Loot	Fête Present
Bullpup	Loot	Fête Present
Cerberpup	Loot	Fête Present
Dwarf Rabbit	Loot	Fête Present
Gaelikitten	Loot	Fête Present
Miniature White Knight	Loot	Fête Present
Morpho	Loot	Fête Present
Nutkin	Loot	Fête Present
Owlet	Loot	Fête Present
Ugly Duckling	Loot	Fête Present
Ballroom Etiquette - Concealing Meals	Loot	Fête Present
Ballroom Etiquette - Emphatic Elucidation	Loot	Fête Present
Ballroom Etiquette - Intelligent Impressions	Loot	Fête Present
Ballroom Etiquette - The Winsome Wallflower	Loot	Fête Present
Modern Aesthetics - Controlled Chaos	Loot	Fête Present
Modern Aesthetics - Modern Legend	Loot	Fête Present
Modern Aesthetics - Saintly Style	Loot	Fête Present
Born of the Boughs - The Theme of Gridania Orchestrion Roll	Loot	Fête Present
Fealty Orchestrion Roll	Loot	Fête Present
Hearthward Orchestrion Roll	Loot	Fête Present
The Heavens' Ward Orchestrion Roll	Loot	Fête Present
Navigator's Glory - The Theme of Limsa Lominsa Orchestrion Roll	Loot	Fête Present
Paradise Found Orchestrion Roll	Loot	Fête Present
Stone and Steel Orchestrion Roll	Loot	Fête Present
The Twin Faces of Fate - The Theme of Ul'dah Orchestrion Roll	Loot	Fête Present
Tricksome Orchestrion Roll	Loot	Fête Present
Upon the Rocks Orchestrion Roll	Loot	Fête Present
What Is Love? Orchestrion Roll	Loot	Fête Present
Calming Checkered Parasol	Loot	Fête Present
Cheerful Checkered Parasol	Loot	Fête Present
Parasol	Loot	Fête Present
Pastoral Dot Parasol	Loot	Fête Present
Sky Blue Parasol	Loot	Fête Present
Expanse Barding	Loot	Fête Present
Hive Barding	Loot	Fête Present
Horde Barding	Loot	Fête Present
Ice Barding	Loot	Fête Present
Levin Barding	Loot	Fête Present
Machinist Barding	Loot	Fête Present
Sephirotic Barding	Loot	Fête Present
Sophic Barding	Loot	Fête Present
Tidal Barding	Loot	Fête Present
Zurvanite Barding	Loot	Fête Present
Craftsman's Apron	Loot	Fête Present
Craftsman's Singlet	Loot	Fête Present
Craftsman's Coverall Bottoms	Loot	Fête Present
Craftsman's Leather Shoes	Loot	Fête Present
Skyworker's Helmet	Loot	Fête Present
Skyworker's Singlet	Loot	Fête Present
Skyworker's Bottoms	Loot	Fête Present
Skyworker's Boots	Loot	Fête Present
Apron Rack	Loot	Fête Present
Azure Dragoon Portrait	Loot	Fête Present
Birdbath	Loot	Fête Present
Brick Garden Circle	Loot	Fête Present
Fête Party Balloons	Loot	Fête Present
Fête Skyrise Balloon	Loot	Fête Present
Fortemps Sofa	Loot	Fête Present
Garment Rack	Loot	Fête Present
Ishgardian Display Stand	Loot	Fête Present
Ishgardian Stove	Loot	Fête Present
Lord Commander Portrait	Loot	Fête Present
Plush Pile	Loot	Fête Present
Stuffed Cait Sith	Loot	Fête Present
Stuffed Estinien	Loot	Fête Present
Verdant Partition	Loot	Fête Present
Genji Shichishito	Loot	Genji Weapon Coffer
Genji Shield	Loot	Genji Weapon Coffer
Genji Greataxe	Loot	Genji Weapon Coffer
Genji Nagamaki	Loot	Genji Weapon Coffer
Genji Naginata	Loot	Genji Weapon Coffer
Genji Chakrams	Loot	Genji Weapon Coffer
Genji Katana	Loot	Genji Weapon Coffer
Genji Phurpa	Loot	Genji Weapon Coffer
Genji Greatbow	Loot	Genji Weapon Coffer
Genji Arquebus	Loot	Genji Weapon Coffer
Genji Rod	Loot	Genji Weapon Coffer
Genji Grimoire	Loot	Genji Weapon Coffer
Genji Rapier	Loot	Genji Weapon Coffer
Genji Cane	Loot	Genji Weapon Coffer
Genji Codex	Loot	Genji Weapon Coffer
Genji Ephemeris	Loot	Genji Weapon Coffer
Diamond Sword	Loot	Diamond Weapon Coffer
Diamond Shield	Loot	Diamond Weapon Coffer
Diamond Axe	Loot	Diamond Weapon Coffer
Diamond Greatsword	Loot	Diamond Weapon Coffer
Diamond Halberd	Loot	Diamond Weapon Coffer
Diamond Knuckles	Loot	Diamond Weapon Coffer
Diamond Katana	Loot	Diamond Weapon Coffer
Diamond Daggers	Loot	Diamond Weapon Coffer
Diamond Bow	Loot	Diamond Weapon Coffer
Diamond Musketoon	Loot	Diamond Weapon Coffer
Diamond Rod	Loot	Diamond Weapon Coffer
Diamond Grimoire	Loot	Diamond Weapon Coffer
Diamond Tuck	Loot	Diamond Weapon Coffer
Diamond Cane	Loot	Diamond Weapon Coffer
Diamond Codex	Loot	Diamond Weapon Coffer
Diamond Sextant	Loot	Diamond Weapon Coffer
Omega Sword	Loot	Omega Weapon Coffer
Omega Shield	Loot	Omega Weapon Coffer
Omega Battleaxe	Loot	Omega Weapon Coffer
Omega Claymore	Loot	Omega Weapon Coffer
Omega Bayonet	Loot	Omega Weapon Coffer
Omega Trident	Loot	Omega Weapon Coffer
Omega Knuckles	Loot	Omega Weapon Coffer
Omega Samurai Blade	Loot	Omega Weapon Coffer
Omega Sickles	Loot	Omega Weapon Coffer
Omega Bow	Loot	Omega Weapon Coffer
Omegafire	Loot	Omega Weapon Coffer
Omega Chakrams	Loot	Omega Weapon Coffer
Omega Rod	Loot	Omega Weapon Coffer
Omega Grimoire	Loot	Omega Weapon Coffer
Omega Smallsword	Loot	Omega Weapon Coffer
Omega Cane	Loot	Omega Weapon Coffer
Omega Codex	Loot	Omega Weapon Coffer
Omega Torquetum	Loot	Omega Weapon Coffer
Edengrace Bastard Sword	Loot	Edengrace Weapon Coffer
Edengrace Shield	Loot	Edengrace Weapon Coffer
Edengrace Battleaxe	Loot	Edengrace Weapon Coffer
Edengrace Greatsword	Loot	Edengrace Weapon Coffer
Edengrace Manatrigger	Loot	Edengrace Weapon Coffer
Edengrace Spear	Loot	Edengrace Weapon Coffer
Edengrace Knuckles	Loot	Edengrace Weapon Coffer
Edengrace Blade	Loot	Edengrace Weapon Coffer
Edengrace Knives	Loot	Edengrace Weapon Coffer
Edengrace Harp Bow	Loot	Edengrace Weapon Coffer
Edengrace Revolver	Loot	Edengrace Weapon Coffer
Edengrace Tathlums	Loot	Edengrace Weapon Coffer
Edengrace Rod	Loot	Edengrace Weapon Coffer
Book of Grace	Loot	Edengrace Weapon Coffer
Edengrace Rapier	Loot	Edengrace Weapon Coffer
Edengrace Cane	Loot	Edengrace Weapon Coffer
Word of Grace	Loot	Edengrace Weapon Coffer
Edengrace Planisphere	Loot	Edengrace Weapon Coffer
Edengrace Armet of Fending	Loot	Edengrace Head Gear Coffer
Edengrace Helm of Maiming	Loot	Edengrace Head Gear Coffer
Edengrace Temple Chain of Striking	Loot	Edengrace Head Gear Coffer
Edengrace Circlet of Scouting	Loot	Edengrace Head Gear Coffer
Edengrace Helm of Aiming	Loot	Edengrace Head Gear Coffer
Edengrace Circlet of Casting	Loot	Edengrace Head Gear Coffer
Edengrace Temple Chain of Healing	Loot	Edengrace Head Gear Coffer
Edengrace Mail of Fending	Loot	Edengrace Chest Gear Coffer
Edengrace Mail of Maiming	Loot	Edengrace Chest Gear Coffer
Edengrace Robe of Striking	Loot	Edengrace Chest Gear Coffer
Edengrace Jacket of Scouting	Loot	Edengrace Chest Gear Coffer
Edengrace Mail of Aiming	Loot	Edengrace Chest Gear Coffer
Edengrace Jacket of Casting	Loot	Edengrace Chest Gear Coffer
Edengrace Robe of Healing	Loot	Edengrace Chest Gear Coffer
Edengrace Gauntlets of Fending	Loot	Edengrace Hand Gear Coffer
Edengrace Gauntlets of Maiming	Loot	Edengrace Hand Gear Coffer
Edengrace Armlets of Striking	Loot	Edengrace Hand Gear Coffer
Edengrace Halfgloves of Scouting	Loot	Edengrace Hand Gear Coffer
Edengrace Gauntlets of Aiming	Loot	Edengrace Hand Gear Coffer
Edengrace Halfgloves of Casting	Loot	Edengrace Hand Gear Coffer
Edengrace Armlets of Healing	Loot	Edengrace Hand Gear Coffer
Edengrace Trousers of Fending	Loot	Edengrace Leg Gear Coffer
Edengrace Trousers of Maiming	Loot	Edengrace Leg Gear Coffer
Edengrace Pantaloons of Striking	Loot	Edengrace Leg Gear Coffer
Edengrace Breeches of Scouting	Loot	Edengrace Leg Gear Coffer
Edengrace Trousers of Aiming	Loot	Edengrace Leg Gear Coffer
Edengrace Breeches of Casting	Loot	Edengrace Leg Gear Coffer
Edengrace Pantaloons of Healing	Loot	Edengrace Leg Gear Coffer
Edengrace Greaves of Fending	Loot	Edengrace Foot Gear Coffer
Edengrace Greaves of Maiming	Loot	Edengrace Foot Gear Coffer
Edengrace Sandals of Striking	Loot	Edengrace Foot Gear Coffer
Edengrace Thighboots of Scouting	Loot	Edengrace Foot Gear Coffer
Edengrace Greaves of Aiming	Loot	Edengrace Foot Gear Coffer
Edengrace Thighboots of Casting	Loot	Edengrace Foot Gear Coffer
Edengrace Sandals of Healing	Loot	Edengrace Foot Gear Coffer
Edengrace Tassets of Fending	Loot	Edengrace Waist Gear Coffer
Edengrace Tassets of Maiming	Loot	Edengrace Waist Gear Coffer
Edengrace Tassets of Striking	Loot	Edengrace Waist Gear Coffer
Edengrace Tassets of Scouting	Loot	Edengrace Waist Gear Coffer
Edengrace Tassets of Aiming	Loot	Edengrace Waist Gear Coffer
Edengrace Tassets of Casting	Loot	Edengrace Waist Gear Coffer
Edengrace Tassets of Healing	Loot	Edengrace Waist Gear Coffer
Edengrace Earring of Fending	Loot	Edengrace Earring Coffer
Edengrace Earring of Slaying	Loot	Edengrace Earring Coffer
Edengrace Earring of Aiming	Loot	Edengrace Earring Coffer
Edengrace Earring of Casting	Loot	Edengrace Earring Coffer
Edengrace Earring of Healing	Loot	Edengrace Earring Coffer
Edengrace Choker of Fending	Loot	Edengrace Necklace Coffer
Edengrace Choker of Slaying	Loot	Edengrace Necklace Coffer
Edengrace Choker of Aiming	Loot	Edengrace Necklace Coffer
Edengrace Choker of Casting	Loot	Edengrace Necklace Coffer
Edengrace Choker of Healing	Loot	Edengrace Necklace Coffer
Edengrace Bracelet of Fending	Loot	Edengrace Bracelet Coffer
Edengrace Bracelet of Slaying	Loot	Edengrace Bracelet Coffer
Edengrace Bracelet of Aiming	Loot	Edengrace Bracelet Coffer
Edengrace Bracelet of Casting	Loot	Edengrace Bracelet Coffer
Edengrace Bracelet of Healing	Loot	Edengrace Bracelet Coffer
Edengrace Ring of Fending	Loot	Edengrace Ring Coffer
Edengrace Ring of Slaying	Loot	Edengrace Ring Coffer
Edengrace Ring of Aiming	Loot	Edengrace Ring Coffer
Edengrace Ring of Casting	Loot	Edengrace Ring Coffer
Edengrace Ring of Healing	Loot	Edengrace Ring Coffer
Edenchoir Bastard Sword	Loot	Edenchoir Weapon Coffer
Edenchoir Scutum	Loot	Edenchoir Weapon Coffer
Edenchoir Jamadhars	Loot	Edenchoir Weapon Coffer
Edenchoir Battleaxe	Loot	Edenchoir Weapon Coffer
Edenchoir Fork	Loot	Edenchoir Weapon Coffer
Edenchoir Harp Bow	Loot	Edenchoir Weapon Coffer
Edenchoir Daggers	Loot	Edenchoir Weapon Coffer
Edenchoir Greatsword	Loot	Edenchoir Weapon Coffer
Edenchoir Arquebus	Loot	Edenchoir Weapon Coffer
Edenchoir Cane	Loot	Edenchoir Weapon Coffer
Edenchoir Rod	Loot	Edenchoir Weapon Coffer
Edenchoir Index	Loot	Edenchoir Weapon Coffer
Edenchoir Codex	Loot	Edenchoir Weapon Coffer
Edenchoir Torquetum	Loot	Edenchoir Weapon Coffer
Edenchoir Samurai Blade	Loot	Edenchoir Weapon Coffer
Edenchoir Rapier	Loot	Edenchoir Weapon Coffer
Edenchoir Gunblade	Loot	Edenchoir Weapon Coffer
Edenchoir Chakrams	Loot	Edenchoir Weapon Coffer
Edenchoir Helm of Fending	Loot	Edenchoir Head Gear Coffer
Edenchoir Helm of Maiming	Loot	Edenchoir Head Gear Coffer
Edenchoir Eyepatch of Striking	Loot	Edenchoir Head Gear Coffer
Edenchoir Eyepatch of Scouting	Loot	Edenchoir Head Gear Coffer
Edenchoir Chapeau of Aiming	Loot	Edenchoir Head Gear Coffer
Edenchoir Hat of Casting	Loot	Edenchoir Head Gear Coffer
Edenchoir Wings of Healing	Loot	Edenchoir Head Gear Coffer
Edenchoir Mail of Fending	Loot	Edenchoir Chest Gear Coffer
Edenchoir Mail of Maiming	Loot	Edenchoir Chest Gear Coffer
Edenchoir Gambison of Striking	Loot	Edenchoir Chest Gear Coffer
Edenchoir Gambison of Scouting	Loot	Edenchoir Chest Gear Coffer
Edenchoir Gambison of Aiming	Loot	Edenchoir Chest Gear Coffer
Edenchoir Tunic of Casting	Loot	Edenchoir Chest Gear Coffer
Edenchoir Tunic of Healing	Loot	Edenchoir Chest Gear Coffer
Edenchoir Gauntlets of Fending	Loot	Edenchoir Hand Gear Coffer
Edenchoir Gauntlets of Maiming	Loot	Edenchoir Hand Gear Coffer
Edenchoir Gauntlets of Striking	Loot	Edenchoir Hand Gear Coffer
Edenchoir Gauntlets of Scouting	Loot	Edenchoir Hand Gear Coffer
Edenchoir Vambraces of Aiming	Loot	Edenchoir Hand Gear Coffer
Edenchoir Armlets of Casting	Loot	Edenchoir Hand Gear Coffer
Edenchoir Armlets of Healing	Loot	Edenchoir Hand Gear Coffer
Edenchoir Cuisses of Fending	Loot	Edenchoir Leg Gear Coffer
Edenchoir Cuisses of Maiming	Loot	Edenchoir Leg Gear Coffer
Edenchoir Trousers of Striking	Loot	Edenchoir Leg Gear Coffer
Edenchoir Breeches of Scouting	Loot	Edenchoir Leg Gear Coffer
Edenchoir Trousers of Aiming	Loot	Edenchoir Leg Gear Coffer
Edenchoir Breeches of Casting	Loot	Edenchoir Leg Gear Coffer
Edenchoir Breeches of Healing	Loot	Edenchoir Leg Gear Coffer
Edenchoir Sollerets of Fending	Loot	Edenchoir Foot Gear Coffer
Edenchoir Sollerets of Maiming	Loot	Edenchoir Foot Gear Coffer
Edenchoir Sollerets of Striking	Loot	Edenchoir Foot Gear Coffer
Edenchoir Sollerets of Scouting	Loot	Edenchoir Foot Gear Coffer
Edenchoir Shoes of Aiming	Loot	Edenchoir Foot Gear Coffer
Edenchoir Boots of Casting	Loot	Edenchoir Foot Gear Coffer
Edenchoir Boots of Healing	Loot	Edenchoir Foot Gear Coffer
Edenchoir Tassets of Fending	Loot	Edenchoir Waist Gear Coffer
Edenchoir Tassets of Maiming	Loot	Edenchoir Waist Gear Coffer
Edenchoir Tassets of Striking	Loot	Edenchoir Waist Gear Coffer
Edenchoir Tassets of Scouting	Loot	Edenchoir Waist Gear Coffer
Edenchoir Tassets of Aiming	Loot	Edenchoir Waist Gear Coffer
Edenchoir Tassets of Casting	Loot	Edenchoir Waist Gear Coffer
Edenchoir Tassets of Healing	Loot	Edenchoir Waist Gear Coffer
Edenchoir Earrings of Fending	Loot	Edenchoir Earring Coffer
Edenchoir Earrings of Slaying	Loot	Edenchoir Earring Coffer
Edenchoir Earrings of Aiming	Loot	Edenchoir Earring Coffer
Edenchoir Earrings of Casting	Loot	Edenchoir Earring Coffer
Edenchoir Earrings of Healing	Loot	Edenchoir Earring Coffer
Edenchoir Choker of Fending	Loot	Edenchoir Necklace Coffer
Edenchoir Choker of Slaying	Loot	Edenchoir Necklace Coffer
Edenchoir Choker of Aiming	Loot	Edenchoir Necklace Coffer
Edenchoir Choker of Casting	Loot	Edenchoir Necklace Coffer
Edenchoir Choker of Healing	Loot	Edenchoir Necklace Coffer
Edenchoir Wristband of Fending	Loot	Edenchoir Bracelet Coffer
Edenchoir Wristband of Slaying	Loot	Edenchoir Bracelet Coffer
Edenchoir Wristband of Aiming	Loot	Edenchoir Bracelet Coffer
Edenchoir Wristband of Casting	Loot	Edenchoir Bracelet Coffer
Edenchoir Wristband of Healing	Loot	Edenchoir Bracelet Coffer
Edenchoir Ring of Fending	Loot	Edenchoir Ring Coffer
Edenchoir Ring of Slaying	Loot	Edenchoir Ring Coffer
Edenchoir Ring of Aiming	Loot	Edenchoir Ring Coffer
Edenchoir Ring of Casting	Loot	Edenchoir Ring Coffer
Edenchoir Ring of Healing	Loot	Edenchoir Ring Coffer
Edenmorn Bastard Sword	Loot	Edenmorn Weapon Coffer
Edenmorn Scutum	Loot	Edenmorn Weapon Coffer
Edenmorn Sainti	Loot	Edenmorn Weapon Coffer
Edenmorn Battleaxe	Loot	Edenmorn Weapon Coffer
Edenmorn Halberd	Loot	Edenmorn Weapon Coffer
Edenmorn Cavalry Bow	Loot	Edenmorn Weapon Coffer
Edenmorn Main Gauches	Loot	Edenmorn Weapon Coffer
Edenmorn Zweihander	Loot	Edenmorn Weapon Coffer
Edenmorn Pistol	Loot	Edenmorn Weapon Coffer
Edenmorn Cane	Loot	Edenmorn Weapon Coffer
Edenmorn Rod	Loot	Edenmorn Weapon Coffer
Edenmorn Index	Loot	Edenmorn Weapon Coffer
Edenmorn Codex	Loot	Edenmorn Weapon Coffer
Edenmorn Torquetum	Loot	Edenmorn Weapon Coffer
Edenmorn Samurai Blade	Loot	Edenmorn Weapon Coffer
Edenmorn Rapier	Loot	Edenmorn Weapon Coffer
Edenmorn Gunblade	Loot	Edenmorn Weapon Coffer
Edenmorn Chakrams	Loot	Edenmorn Weapon Coffer
Edenmorn Mask of Fending	Loot	Edenmorn Head Gear Coffer
Edenmorn Mask of Maiming	Loot	Edenmorn Head Gear Coffer
Edenmorn Eye Mask of Striking	Loot	Edenmorn Head Gear Coffer
Edenmorn Eye Mask of Scouting	Loot	Edenmorn Head Gear Coffer
Edenmorn Mask of Aiming	Loot	Edenmorn Head Gear Coffer
Edenmorn Hat of Casting	Loot	Edenmorn Head Gear Coffer
Edenmorn Hat of Healing	Loot	Edenmorn Head Gear Coffer
Edenmorn Coat of Fending	Loot	Edenmorn Chest Gear Coffer
Edenmorn Coat of Maiming	Loot	Edenmorn Chest Gear Coffer
Edenmorn Bolero of Striking	Loot	Edenmorn Chest Gear Coffer
Edenmorn Bolero of Scouting	Loot	Edenmorn Chest Gear Coffer
Edenmorn Coat of Aiming	Loot	Edenmorn Chest Gear Coffer
Edenmorn Gown of Casting	Loot	Edenmorn Chest Gear Coffer
Edenmorn Gown of Healing	Loot	Edenmorn Chest Gear Coffer
Edenmorn Armguards of Fending	Loot	Edenmorn Hand Gear Coffer
Edenmorn Armguards of Maiming	Loot	Edenmorn Hand Gear Coffer
Edenmorn Fingerless Gloves of Striking	Loot	Edenmorn Hand Gear Coffer
Edenmorn Fingerless Gloves of Scouting	Loot	Edenmorn Hand Gear Coffer
Edenmorn Armguards of Aiming	Loot	Edenmorn Hand Gear Coffer
Edenmorn Dress Sleeves of Casting	Loot	Edenmorn Hand Gear Coffer
Edenmorn Dress Sleeves of Healing	Loot	Edenmorn Hand Gear Coffer
Edenmorn Hose of Fending	Loot	Edenmorn Leg Gear Coffer
Edenmorn Hose of Maiming	Loot	Edenmorn Leg Gear Coffer
Edenmorn Hose of Striking	Loot	Edenmorn Leg Gear Coffer
Edenmorn Hose of Scouting	Loot	Edenmorn Leg Gear Coffer
Edenmorn Hose of Aiming	Loot	Edenmorn Leg Gear Coffer
Edenmorn Chausses of Casting	Loot	Edenmorn Leg Gear Coffer
Edenmorn Chausses of Healing	Loot	Edenmorn Leg Gear Coffer
Edenmorn Sabatons of Fending	Loot	Edenmorn Foot Gear Coffer
Edenmorn Sabatons of Maiming	Loot	Edenmorn Foot Gear Coffer
Edenmorn Thighboots of Striking	Loot	Edenmorn Foot Gear Coffer
Edenmorn Thighboots of Scouting	Loot	Edenmorn Foot Gear Coffer
Edenmorn Sabatons of Aiming	Loot	Edenmorn Foot Gear Coffer
Edenmorn Boots of Casting	Loot	Edenmorn Foot Gear Coffer
Edenmorn Boots of Healing	Loot	Edenmorn Foot Gear Coffer
Edenmorn Leather Belt of Fending	Loot	Edenmorn Waist Gear Coffer
Edenmorn Leather Belt of Maiming	Loot	Edenmorn Waist Gear Coffer
Edenmorn Leather Belt of Striking	Loot	Edenmorn Waist Gear Coffer
Edenmorn Leather Belt of Scouting	Loot	Edenmorn Waist Gear Coffer
Edenmorn Leather Belt of Aiming	Loot	Edenmorn Waist Gear Coffer
Edenmorn Leather Belt of Casting	Loot	Edenmorn Waist Gear Coffer
Edenmorn Leather Belt of Healing	Loot	Edenmorn Waist Gear Coffer
Edenmorn Earrings of Fending	Loot	Edenmorn Earring Coffer
Edenmorn Earrings of Slaying	Loot	Edenmorn Earring Coffer
Edenmorn Earrings of Aiming	Loot	Edenmorn Earring Coffer
Edenmorn Earrings of Casting	Loot	Edenmorn Earring Coffer
Edenmorn Earrings of Healing	Loot	Edenmorn Earring Coffer
Edenmorn Necklace of Fending	Loot	Edenmorn Necklace Coffer
Edenmorn Necklace of Slaying	Loot	Edenmorn Necklace Coffer
Edenmorn Necklace of Aiming	Loot	Edenmorn Necklace Coffer
Edenmorn Necklace of Casting	Loot	Edenmorn Necklace Coffer
Edenmorn Necklace of Healing	Loot	Edenmorn Necklace Coffer
Edenmorn Wristlet of Fending	Loot	Edenmorn Bracelet Coffer
Edenmorn Wristlet of Slaying	Loot	Edenmorn Bracelet Coffer
Edenmorn Wristlet of Aiming	Loot	Edenmorn Bracelet Coffer
Edenmorn Wristlet of Casting	Loot	Edenmorn Bracelet Coffer
Edenmorn Wristlet of Healing	Loot	Edenmorn Bracelet Coffer
Edenmorn Ring of Fending	Loot	Edenmorn Ring Coffer
Edenmorn Ring of Slaying	Loot	Edenmorn Ring Coffer
Edenmorn Ring of Aiming	Loot	Edenmorn Ring Coffer
Edenmorn Ring of Casting	Loot	Edenmorn Ring Coffer
Edenmorn Ring of Healing	Loot	Edenmorn Ring Coffer
Antiquated Galatyn	Loot	Chivalrous Armor Coffer
Antiquated Evalach	Loot	Chivalrous Armor Coffer
Antiquated Chivalrous Circlet	Loot	Chivalrous Armor Coffer
Antiquated Chivalrous Surcoat	Loot	Chivalrous Armor Coffer
Antiquated Chivalrous Gauntlets	Loot	Chivalrous Armor Coffer
Antiquated Chivalrous Cuisses	Loot	Chivalrous Armor Coffer
Antiquated Chivalrous Sollerets	Loot	Chivalrous Armor Coffer
Antiquated Sudarshana Chakra	Loot	Pacifist's Attire Coffer
Antiquated Pacifist's Circlet	Loot	Pacifist's Attire Coffer
Antiquated Pacifist's Vest	Loot	Pacifist's Attire Coffer
Antiquated Pacifist's Armguards	Loot	Pacifist's Attire Coffer
Antiquated Pacifist's Gaskins	Loot	Pacifist's Attire Coffer
Antiquated Pacifist's Boots	Loot	Pacifist's Attire Coffer
Antiquated Farsha	Loot	Brutal Armor Coffer
Antiquated Brutal Visor	Loot	Brutal Armor Coffer
Antiquated Brutal Lorica	Loot	Brutal Armor Coffer
Antiquated Brutal Gauntlets	Loot	Brutal Armor Coffer
Antiquated Brutal Breeches	Loot	Brutal Armor Coffer
Antiquated Brutal Sollerets	Loot	Brutal Armor Coffer
Antiquated Failnaught	Loot	Storyteller's Attire Coffer
Antiquated Storyteller's Chapeau	Loot	Storyteller's Attire Coffer
Antiquated Storyteller's Coat	Loot	Storyteller's Attire Coffer
Antiquated Storyteller's Gloves	Loot	Storyteller's Attire Coffer
Antiquated Storyteller's Bottoms	Loot	Storyteller's Attire Coffer
Antiquated Storyteller's Boots	Loot	Storyteller's Attire Coffer
Antiquated Aymur	Loot	Seventh Heaven Attire Coffer
Antiquated Seventh Heaven Circlet	Loot	Seventh Heaven Attire Coffer
Antiquated Seventh Heaven Top	Loot	Seventh Heaven Attire Coffer
Antiquated Seventh Heaven Fingerless Gloves	Loot	Seventh Heaven Attire Coffer
Antiquated Seventh Heaven Bottoms	Loot	Seventh Heaven Attire Coffer
Antiquated Seventh Heaven Thighboots	Loot	Seventh Heaven Attire Coffer
Antiquated Vanargand	Loot	Seventh Hell Attire Coffer
Antiquated Seventh Hell Petasos	Loot	Seventh Hell Attire Coffer
Antiquated Seventh Hell Coat	Loot	Seventh Hell Attire Coffer
Antiquated Seventh Hell Gloves	Loot	Seventh Hell Attire Coffer
Antiquated Seventh Hell Breeches	Loot	Seventh Hell Attire Coffer
Antiquated Seventh Hell Thighboots	Loot	Seventh Hell Attire Coffer
Antiquated Lemegeton	Loot	Channeler's Attire Coffer
Antiquated Channeler's Horn	Loot	Channeler's Attire Coffer
Antiquated Channeler's Vest	Loot	Channeler's Attire Coffer
Antiquated Channeler's Armlets	Loot	Channeler's Attire Coffer
Antiquated Channeler's Halfslops	Loot	Channeler's Attire Coffer
Antiquated Channeler's Boots	Loot	Channeler's Attire Coffer
Antiquated Organum	Loot	Orator's Attire Coffer
Antiquated Orator's Mortarboard	Loot	Orator's Attire Coffer
Antiquated Orator's Coat	Loot	Orator's Attire Coffer
Antiquated Orator's Cuffs	Loot	Orator's Attire Coffer
Antiquated Orator's Bottoms	Loot	Orator's Attire Coffer
Antiquated Orator's Shoes	Loot	Orator's Attire Coffer
Antiquated Nagi	Loot	Kage-kakushi Garb Coffer
Antiquated Kage-kakushi Somen	Loot	Kage-kakushi Garb Coffer
Antiquated Kage-kakushi Chainmail	Loot	Kage-kakushi Garb Coffer
Antiquated Kage-kakushi Tekko	Loot	Kage-kakushi Garb Coffer
Antiquated Kage-kakushi Hakama	Loot	Kage-kakushi Garb Coffer
Antiquated Kage-kakushi Kyahan	Loot	Kage-kakushi Garb Coffer
Antiquated Caladbolg	Loot	Abyss Armor Coffer
Antiquated Abyss Burgeonet	Loot	Abyss Armor Coffer
Antiquated Abyss Cuirass	Loot	Abyss Armor Coffer
Antiquated Abyss Gauntlets	Loot	Abyss Armor Coffer
Antiquated Abyss Flanchard	Loot	Abyss Armor Coffer
Antiquated Abyss Sollerets	Loot	Abyss Armor Coffer
Antiquated Outsider	Loot	Gunner's Armor Coffer
Antiquated Gunner's Goggles	Loot	Gunner's Armor Coffer
Antiquated Gunner's Coat	Loot	Gunner's Armor Coffer
Antiquated Gunner's Gloves	Loot	Gunner's Armor Coffer
Antiquated Gunner's Trousers	Loot	Gunner's Armor Coffer
Antiquated Gunner's Thighboots	Loot	Gunner's Armor Coffer
Antiquated Pleiades	Loot	Constellation Attire Coffer
Antiquated Constellation Turban	Loot	Constellation Attire Coffer
Antiquated Constellation Top	Loot	Constellation Attire Coffer
Antiquated Constellation Armlets	Loot	Constellation Attire Coffer
Antiquated Constellation Gaskins	Loot	Constellation Attire Coffer
Antiquated Constellation Sandals	Loot	Constellation Attire Coffer
Antiquated Kiku-ichimonji	Loot	Myochin Armor Coffer
Antiquated Myochin Jingasa	Loot	Myochin Armor Coffer
Antiquated Myochin Haori	Loot	Myochin Armor Coffer
Antiquated Myochin Tekko	Loot	Myochin Armor Coffer
Antiquated Myochin Hakama	Loot	Myochin Armor Coffer
Antiquated Myochin Geta	Loot	Myochin Armor Coffer
Antiquated Murgleis	Loot	Duelist's Attire Coffer
Antiquated Duelist's Chapeau	Loot	Duelist's Attire Coffer
Antiquated Duelist's Tabard	Loot	Duelist's Attire Coffer
Antiquated Duelist's Gloves	Loot	Duelist's Attire Coffer
Antiquated Duelist's Breeches	Loot	Duelist's Attire Coffer
Antiquated Duelist's Thighboots	Loot	Duelist's Attire Coffer
Antiquated Ryunohige	Loot	Trueblood Attire Coffer
Antiquated Trueblood Armet	Loot	Trueblood Attire Coffer
Antiquated Trueblood Mail	Loot	Trueblood Attire Coffer
Antiquated Trueblood Gauntlets	Loot	Trueblood Attire Coffer
Antiquated Trueblood Brais	Loot	Trueblood Attire Coffer
Antiquated Trueblood Greaves	Loot	Trueblood Attire Coffer
Nameless Hachigane	Loot	Nameless Armor Coffer
Nameless Togi	Loot	Nameless Armor Coffer
Nameless Tekko	Loot	Nameless Armor Coffer
Nameless Hakama	Loot	Nameless Armor Coffer
Nameless Kyahan	Loot	Nameless Armor Coffer
Red Hat	Loot	Red Attire Coffer
Red Bliaud	Loot	Red Attire Coffer
Red Gloves	Loot	Red Attire Coffer
Red Gaskins	Loot	Red Attire Coffer
Red Boots	Loot	Red Attire Coffer
True Blue Hat	Loot	True Blue Attire Coffer
True Blue Coat	Loot	True Blue Attire Coffer
True Blue Gloves	Loot	True Blue Attire Coffer
True Blue Trousers	Loot	True Blue Attire Coffer
True Blue Boots	Loot	True Blue Attire Coffer
Magus's Mask	Loot	Magus's Attire Coffer
Magus's Jacket	Loot	Magus's Attire Coffer
Magus's Gloves	Loot	Magus's Attire Coffer
Magus's Trousers	Loot	Magus's Attire Coffer
Magus's Shoes	Loot	Magus's Attire Coffer
Mirage Hat	Loot	Mirage Gear Coffer
Mirage Coatee	Loot	Mirage Gear Coffer
Mirage Gloves	Loot	Mirage Gear Coffer
Mirage Bottoms	Loot	Mirage Gear Coffer
Mirage Boots	Loot	Mirage Gear Coffer
Outsider's Circlet	Loot	Outsider's Attire Coffer
Outsider's Jacket	Loot	Outsider's Attire Coffer
Outsider's Gloves	Loot	Outsider's Attire Coffer
Outsider's Chaps	Loot	Outsider's Attire Coffer
Outsider's Boots	Loot	Outsider's Attire Coffer
Softstepper's Turban	Loot	Softstepper's Attire Coffer
Softstepper's Bolero	Loot	Softstepper's Attire Coffer
Softstepper's Gloves	Loot	Softstepper's Attire Coffer
Softstepper's Sarouel	Loot	Softstepper's Attire Coffer
Softstepper's Babouches	Loot	Softstepper's Attire Coffer
Augmented Hellfire Mask of Fending	Loot	Hellfire Armor of Fending Coffer
Augmented Hellfire Armor of Fending	Loot	Hellfire Armor of Fending Coffer
Augmented Hellfire Gauntlets of Fending	Loot	Hellfire Armor of Fending Coffer
Augmented Hellfire Belt of Fending	Loot	Hellfire Armor of Fending Coffer
Augmented Hellfire Breeches of Fending	Loot	Hellfire Armor of Fending Coffer
Augmented Hellfire Sabatons of Fending	Loot	Hellfire Armor of Fending Coffer
Augmented Slipstream Helm of Maiming	Loot	Slipstream Armor of Maiming Coffer
Augmented Slipstream Mail of Maiming	Loot	Slipstream Armor of Maiming Coffer
Augmented Slipstream Gauntlets of Maiming	Loot	Slipstream Armor of Maiming Coffer
Augmented Slipstream Belt of Maiming	Loot	Slipstream Armor of Maiming Coffer
Augmented Slipstream Breeches of Maiming	Loot	Slipstream Armor of Maiming Coffer
Augmented Slipstream Sabatons of Maiming	Loot	Slipstream Armor of Maiming Coffer
Augmented Hellfire Mask of Striking	Loot	Hellfire Armor of Striking Coffer
Augmented Hellfire Mail of Striking	Loot	Hellfire Armor of Striking Coffer
Augmented Hellfire Gauntlets of Striking	Loot	Hellfire Armor of Striking Coffer
Augmented Hellfire Belt of Striking	Loot	Hellfire Armor of Striking Coffer
Augmented Hellfire Breeches of Striking	Loot	Hellfire Armor of Striking Coffer
Augmented Hellfire Sabatons of Striking	Loot	Hellfire Armor of Striking Coffer
Augmented Torrent Mask of Aiming	Loot	Torrent Attire of Aiming Coffer
Augmented Torrent Tabard of Aiming	Loot	Torrent Attire of Aiming Coffer
Augmented Torrent Armguards of Aiming	Loot	Torrent Attire of Aiming Coffer
Augmented Torrent Belt of Aiming	Loot	Torrent Attire of Aiming Coffer
Augmented Torrent Tights of Aiming	Loot	Torrent Attire of Aiming Coffer
Augmented Torrent Boots of Aiming	Loot	Torrent Attire of Aiming Coffer
Augmented Torrent Halfmask of Scouting	Loot	Torrent Attire of Scouting Coffer
Augmented Torrent Tabard of Scouting	Loot	Torrent Attire of Scouting Coffer
Augmented Torrent Armguards of Scouting	Loot	Torrent Attire of Scouting Coffer
Augmented Torrent Belt of Scouting	Loot	Torrent Attire of Scouting Coffer
Augmented Torrent Tights of Scouting	Loot	Torrent Attire of Scouting Coffer
Augmented Torrent Boots of Scouting	Loot	Torrent Attire of Scouting Coffer
Augmented Hailstorm Crown of Casting	Loot	Hailstorm Attire of Casting Coffer
Augmented Hailstorm Coat of Casting	Loot	Hailstorm Attire of Casting Coffer
Augmented Hailstorm Gloves of Casting	Loot	Hailstorm Attire of Casting Coffer
Augmented Hailstorm Belt of Casting	Loot	Hailstorm Attire of Casting Coffer
Augmented Hailstorm Bottoms of Casting	Loot	Hailstorm Attire of Casting Coffer
Augmented Hailstorm Boots of Casting	Loot	Hailstorm Attire of Casting Coffer
Augmented Hailstorm Crown of Healing	Loot	Hailstorm Attire of Healing Coffer
Augmented Hailstorm Coat of Healing	Loot	Hailstorm Attire of Healing Coffer
Augmented Hailstorm Gloves of Healing	Loot	Hailstorm Attire of Healing Coffer
Augmented Hailstorm Belt of Healing	Loot	Hailstorm Attire of Healing Coffer
Augmented Hailstorm Bottoms of Healing	Loot	Hailstorm Attire of Healing Coffer
Augmented Hailstorm Boots of Healing	Loot	Hailstorm Attire of Healing Coffer
Augmented Primal Earrings of Fending	Loot	Primal Accessories of Fending Coffer
Augmented Primal Choker of Fending	Loot	Primal Accessories of Fending Coffer
Augmented Primal Bracelet of Fending	Loot	Primal Accessories of Fending Coffer
Augmented Primal Ring of Fending	Loot	Primal Accessories of Fending Coffer
Augmented Primal Earrings of Slaying	Loot	Primal Accessories of Slaying Coffer
Augmented Primal Choker of Slaying	Loot	Primal Accessories of Slaying Coffer
Augmented Primal Bracelet of Slaying	Loot	Primal Accessories of Slaying Coffer
Augmented Primal Ring of Slaying	Loot	Primal Accessories of Slaying Coffer
Augmented Primal Earrings of Aiming	Loot	Primal Accessories of Aiming Coffer
Augmented Primal Choker of Aiming	Loot	Primal Accessories of Aiming Coffer
Augmented Primal Bracelet of Aiming	Loot	Primal Accessories of Aiming Coffer
Augmented Primal Ring of Aiming	Loot	Primal Accessories of Aiming Coffer
Augmented Primal Earrings of Casting	Loot	Primal Accessories of Casting Coffer
Augmented Primal Choker of Casting	Loot	Primal Accessories of Casting Coffer
Augmented Primal Bracelet of Casting	Loot	Primal Accessories of Casting Coffer
Augmented Primal Ring of Casting	Loot	Primal Accessories of Casting Coffer
Augmented Primal Earrings of Healing	Loot	Primal Accessories of Healing Coffer
Augmented Primal Choker of Healing	Loot	Primal Accessories of Healing Coffer
Augmented Primal Bracelet of Healing	Loot	Primal Accessories of Healing Coffer
Augmented Primal Ring of Healing	Loot	Primal Accessories of Healing Coffer
Hero's Belt of Fending	Loot	Valor Armor Coffer	Warrior's Armor Coffer	Dark Knight's Armor Coffer
Hero's Belt of Maiming	Loot	Wyrm's Armor Coffer
Hero's Belt of Striking	Loot	Melee Attire Coffer	Koga Garb Coffer
Hero's Belt of Aiming	Loot	Bard's Attire Coffer	Junior Machinist's Armor Coffer
Hero's Belt of Casting	Loot	Sorcerer's Attire Coffer	Summoner's Attire Coffer
Hero's Belt of Healing	Loot	Cleric's Attire Coffer	Argute Attire Coffer	Astrologian's Attire Coffer
Valor Coronet	Loot	Valor Armor Coffer
Valor Surcoat	Loot	Valor Armor Coffer
Valor Gauntlets	Loot	Valor Armor Coffer
Valor Cuisses	Loot	Valor Armor Coffer
Valor Sollerets	Loot	Valor Armor Coffer
Melee Circlet	Loot	Melee Attire Coffer
Melee Cyclas	Loot	Melee Attire Coffer
Melee Gloves	Loot	Melee Attire Coffer
Melee Gaskins	Loot	Melee Attire Coffer
Melee Boots	Loot	Melee Attire Coffer
Warrior's Burgeonet	Loot	Warrior's Armor Coffer
Warrior's Cuirass	Loot	Warrior's Armor Coffer
Warrior's Gauntlets	Loot	Warrior's Armor Coffer
Warrior's Breeches	Loot	Warrior's Armor Coffer
Warrior's Jackboots	Loot	Warrior's Armor Coffer
Wyrm's Armet	Loot	Wyrm's Armor Coffer
Wyrm's Mail	Loot	Wyrm's Armor Coffer
Wyrm's Gauntlets	Loot	Wyrm's Armor Coffer
Wyrm's Breeches	Loot	Wyrm's Armor Coffer
Wyrm's Greaves	Loot	Wyrm's Armor Coffer
Bard's Chapeau	Loot	Bard's Attire Coffer
Bard's Ringbands	Loot	Bard's Attire Coffer
Bard's Sandals	Loot	Bard's Attire Coffer
Bard's Shirt	Loot	Bard's Attire Coffer
Bard's Tights	Loot	Bard's Attire Coffer
Koga Hatsuburi	Loot	Koga Garb Coffer
Koga Chainmail	Loot	Koga Garb Coffer
Koga Hakama	Loot	Koga Garb Coffer
Koga Tekko	Loot	Koga Garb Coffer
Koga Kyahan	Loot	Koga Garb Coffer
Cleric's Circlet	Loot	Cleric's Attire Coffer
Cleric's Robe	Loot	Cleric's Attire Coffer
Cleric's Gloves	Loot	Cleric's Attire Coffer
Cleric's Culottes	Loot	Cleric's Attire Coffer
Cleric's Boots	Loot	Cleric's Attire Coffer
Sorcerer's Petasos	Loot	Sorcerer's Attire Coffer
Sorcerer's Coat	Loot	Sorcerer's Attire Coffer
Sorcerer's Gloves	Loot	Sorcerer's Attire Coffer
Sorcerer's Tonban	Loot	Sorcerer's Attire Coffer
Sorcerer's Crakows	Loot	Sorcerer's Attire Coffer
Summoner's Horn	Loot	Summoner's Attire Coffer
Summoner's Doublet	Loot	Summoner's Attire Coffer
Summoner's Ringbands	Loot	Summoner's Attire Coffer
Summoner's Waistclout	Loot	Summoner's Attire Coffer
Summoner's Thighboots	Loot	Summoner's Attire Coffer
Argute Mortarboard	Loot	Argute Attire Coffer
Argute Gown	Loot	Argute Attire Coffer
Argute Gloves	Loot	Argute Attire Coffer
Argute Culottes	Loot	Argute Attire Coffer
Argute Boots	Loot	Argute Attire Coffer
Heavy Wolfram Helm	Loot	Dark Knight's Armor Coffer
Heavy Wolfram Cuirass	Loot	Dark Knight's Armor Coffer
Heavy Wolfram Gauntlets	Loot	Dark Knight's Armor Coffer
Heavy Wolfram Cuisses	Loot	Dark Knight's Armor Coffer
Heavy Wolfram Sabatons	Loot	Dark Knight's Armor Coffer
Cashmere Hat of Aiming	Loot	Junior Machinist's Armor Coffer
Saurian Tabard of Aiming	Loot	Junior Machinist's Armor Coffer
Saurian Gloves of Aiming	Loot	Junior Machinist's Armor Coffer
Cashmere Skirt of Aiming	Loot	Junior Machinist's Armor Coffer
Saurian Boots of Aiming	Loot	Junior Machinist's Armor Coffer
Gold Spectacles	Loot	Astrologian's Attire Coffer
Cashmere Robe of Healing	Loot	Astrologian's Attire Coffer
Saurian Gloves of Healing	Loot	Astrologian's Attire Coffer
Cashmere Skirt of Healing	Loot	Astrologian's Attire Coffer
Saurian Boots of Healing	Loot	Astrologian's Attire Coffer
Fabled Belt of Fending	Loot	Creed Armor Coffer	Ravager's Armor Coffer	Chaos Armor Coffer
Fabled Belt of Maiming	Loot	Dragonlancer's Armor Coffer
Fabled Belt of Striking	Loot	Tantra Armor Coffer
Fabled Belt of Scouting	Loot	Iga Garb Coffer
Fabled Belt of Aiming	Loot	Aoidos' Attire Coffer	Machinist's Armor Coffer
Fabled Belt of Casting	Loot	Goetia Attire Coffer	Caller's Attire Coffer
Fabled Belt of Healing	Loot	Orison Attire Coffer	Savant's Attire Coffer	Welkin Attire Coffer
Creed Wings	Loot	Creed Armor Coffer
Creed Cuirass	Loot	Creed Armor Coffer
Creed Gauntlets	Loot	Creed Armor Coffer
Creed Cuisses	Loot	Creed Armor Coffer
Creed Sabatons	Loot	Creed Armor Coffer
Tantra Tantour	Loot	Tantra Armor Coffer
Tantra Chestwrap	Loot	Tantra Armor Coffer
Tantra Wristwraps	Loot	Tantra Armor Coffer
Tantra Galligaskins	Loot	Tantra Armor Coffer
Tantra Gaiters	Loot	Tantra Armor Coffer
Ravager's Helm	Loot	Ravager's Armor Coffer
Ravager's Cuirass	Loot	Ravager's Armor Coffer
Ravager's Chains	Loot	Ravager's Armor Coffer
Ravager's Breeches	Loot	Ravager's Armor Coffer
Ravager's Warboots	Loot	Ravager's Armor Coffer
Dragonlancer's Mesail	Loot	Dragonlancer's Armor Coffer
Dragonlancer's Plackart	Loot	Dragonlancer's Armor Coffer
Dragonlancer's Vambraces	Loot	Dragonlancer's Armor Coffer
Dragonlancer's Cuissots	Loot	Dragonlancer's Armor Coffer
Dragonlancer's Schynbalds	Loot	Dragonlancer's Armor Coffer
Aoidos' Turban	Loot	Aoidos' Attire Coffer
Aoidos' Cloak	Loot	Aoidos' Attire Coffer
Aoidos' Shoulder Gloves	Loot	Aoidos' Attire Coffer
Aoidos' Tights	Loot	Aoidos' Attire Coffer
Aoidos' Thighboots	Loot	Aoidos' Attire Coffer
Iga Zukin	Loot	Iga Garb Coffer
Iga Ningi	Loot	Iga Garb Coffer
Iga Tekko	Loot	Iga Garb Coffer
Iga Hakama	Loot	Iga Garb Coffer
Iga Kyahan	Loot	Iga Garb Coffer
Orison Hood	Loot	Orison Attire Coffer
Orison Robe	Loot	Orison Attire Coffer
Orison Fingerless Gloves	Loot	Orison Attire Coffer
Orison Skirt	Loot	Orison Attire Coffer
Orison Thighboots	Loot	Orison Attire Coffer
Goetia Tricorne	Loot	Goetia Attire Coffer
Goetia Coat	Loot	Goetia Attire Coffer
Goetia Gloves	Loot	Goetia Attire Coffer
Goetia Chausses	Loot	Goetia Attire Coffer
Goetia Thighboots	Loot	Goetia Attire Coffer
Caller's Horn	Loot	Caller's Attire Coffer
Caller's Himation	Loot	Caller's Attire Coffer
Caller's Armlets	Loot	Caller's Attire Coffer
Caller's Loincloth	Loot	Caller's Attire Coffer
Caller's Sandals	Loot	Caller's Attire Coffer
Savant's Top Hat	Loot	Savant's Attire Coffer
Savant's Overcoat	Loot	Savant's Attire Coffer
Savant's Aethercell Gloves	Loot	Savant's Attire Coffer
Savant's Culottes	Loot	Savant's Attire Coffer
Savant's Boots	Loot	Savant's Attire Coffer
Chaos Burgeonet	Loot	Chaos Armor Coffer
Chaos Cuirass	Loot	Chaos Armor Coffer
Chaos Gauntlets	Loot	Chaos Armor Coffer
Chaos Flanchard	Loot	Chaos Armor Coffer
Chaos Sollerets	Loot	Chaos Armor Coffer
Machinist's Goggles	Loot	Machinist's Armor Coffer
Machinist's Shirt	Loot	Machinist's Armor Coffer
Machinist's Gloves	Loot	Machinist's Armor Coffer
Machinist's Brais	Loot	Machinist's Armor Coffer
Machinist's Boots	Loot	Machinist's Armor Coffer
Welkin Hat	Loot	Welkin Attire Coffer
Welkin Robe	Loot	Welkin Attire Coffer
Welkin Half Sleeves	Loot	Welkin Attire Coffer
Welkin Breeches	Loot	Welkin Attire Coffer
Welkin Shoes	Loot	Welkin Attire Coffer
Augmented Shire Custodian's Earrings	Loot	Shire Custodian's Accessories Coffer
Augmented Shire Custodian's Choker	Loot	Shire Custodian's Accessories Coffer
Augmented Shire Custodian's Bracelet	Loot	Shire Custodian's Accessories Coffer
Augmented Shire Custodian's Ring	Loot	Shire Custodian's Accessories Coffer
Filibuster's Ring of Fending	Loot	Shire Custodian's Accessories Coffer
Augmented Shire Pankratiast's Earring	Loot	Shire Pankratiast's Accessories Coffer
Augmented Shire Pankratiast's Choker	Loot	Shire Pankratiast's Accessories Coffer
Augmented Shire Pankratiast's Bracelets	Loot	Shire Pankratiast's Accessories Coffer
Augmented Shire Pankratiast's Ring	Loot	Shire Pankratiast's Accessories Coffer
Filibuster's Ring of Slaying	Loot	Shire Pankratiast's Accessories Coffer
Augmented Shire Conservator's Earrings	Loot	Shire Conservator's Accessories Coffer
Augmented Shire Conservator's Choker	Loot	Shire Conservator's Accessories Coffer
Augmented Shire Conservator's Bracelet	Loot	Shire Conservator's Accessories Coffer
Augmented Shire Conservator's Ring	Loot	Shire Conservator's Accessories Coffer
Filibuster's Ring of Aiming	Loot	Shire Conservator's Accessories Coffer
Augmented Shire Philosopher's Earring	Loot	Shire Philosopher's Accessories Coffer
Augmented Shire Philosopher's Choker	Loot	Shire Philosopher's Accessories Coffer
Augmented Shire Philosopher's Bracelets	Loot	Shire Philosopher's Accessories Coffer
Augmented Shire Philosopher's Ring	Loot	Shire Philosopher's Accessories Coffer
Filibuster's Ring of Casting	Loot	Shire Philosopher's Accessories Coffer
Augmented Shire Preceptor's Earrings	Loot	Shire Preceptor's Accessories Coffer
Augmented Shire Preceptor's Choker	Loot	Shire Preceptor's Accessories Coffer
Augmented Shire Preceptor's Bracelets	Loot	Shire Preceptor's Accessories Coffer
Augmented Shire Preceptor's Ring	Loot	Shire Preceptor's Accessories Coffer
Filibuster's Ring of Healing	Loot	Shire Preceptor's Accessories Coffer
Deepgold Anelace	Loot	White Oak Weapon Coffer
Deepgold Kite Shield	Loot	White Oak Weapon Coffer
Deepgold Battleaxe	Loot	White Oak Weapon Coffer
Deepgold Claymore	Loot	White Oak Weapon Coffer
Deepgold Gunblade	Loot	White Oak Weapon Coffer
White Oak Partisan	Loot	White Oak Weapon Coffer
Deepgold Katars	Loot	White Oak Weapon Coffer
Deepgold Blade	Loot	White Oak Weapon Coffer
Deepgold Cinquedeas	Loot	White Oak Weapon Coffer
White Oak Composite Bow	Loot	White Oak Weapon Coffer
Deepgold Revolver	Loot	White Oak Weapon Coffer
Deepgold War Quoits	Loot	White Oak Weapon Coffer
White Oak Rod	Loot	White Oak Weapon Coffer
Smilodonskin Grimoire	Loot	White Oak Weapon Coffer
Stonegold Degen	Loot	White Oak Weapon Coffer
White Oak Cane	Loot	White Oak Weapon Coffer
Smilodonskin Codex	Loot	White Oak Weapon Coffer
Stonegold Astrometer	Loot	White Oak Weapon Coffer
Deepgold Helm of Fending	Loot	White Oak Head Gear Coffer
Stonegold Circlet of Maiming	Loot	White Oak Head Gear Coffer
Brightlinen Hood of Striking	Loot	White Oak Head Gear Coffer
Deepgold Mask of Scouting	Loot	White Oak Head Gear Coffer
Brightlinen Hood of Aiming	Loot	White Oak Head Gear Coffer
Brightlinen Cap of Casting	Loot	White Oak Head Gear Coffer
Brightlinen Cap of Healing	Loot	White Oak Head Gear Coffer
Deepgold Cuirass of Fending	Loot	White Oak Chest Gear Coffer
Brightlinen Tabard of Maiming	Loot	White Oak Chest Gear Coffer
Brightlinen Himation of Striking	Loot	White Oak Chest Gear Coffer
Brightlinen Gambison of Scouting	Loot	White Oak Chest Gear Coffer
Brightlinen Himation of Aiming	Loot	White Oak Chest Gear Coffer
Brightlinen Cyclas of Casting	Loot	White Oak Chest Gear Coffer
Brightlinen Cyclas of Healing	Loot	White Oak Chest Gear Coffer
Deepgold Gauntlets of Fending	Loot	White Oak Hand Gear Coffer
Smilodonskin Gloves of Maiming	Loot	White Oak Hand Gear Coffer
Brightlinen Long Gloves of Striking	Loot	White Oak Hand Gear Coffer
Smilodonskin Gloves of Scouting	Loot	White Oak Hand Gear Coffer
Brightlinen Long Gloves of Aiming	Loot	White Oak Hand Gear Coffer
Smilodonskin Armguards of Casting	Loot	White Oak Hand Gear Coffer
Smilodonskin Armguards of Healing	Loot	White Oak Hand Gear Coffer
Smilodonskin Trousers of Fending	Loot	White Oak Leg Gear Coffer
Smilodonskin Trousers of Maiming	Loot	White Oak Leg Gear Coffer
Brightlinen Bottoms of Striking	Loot	White Oak Leg Gear Coffer
Brightlinen Hose of Scouting	Loot	White Oak Leg Gear Coffer
Brightlinen Bottoms of Aiming	Loot	White Oak Leg Gear Coffer
Brightlinen Hose of Casting	Loot	White Oak Leg Gear Coffer
Brightlinen Hose of Healing	Loot	White Oak Leg Gear Coffer
Deepgold Sollerets of Fending	Loot	White Oak Foot Gear Coffer
Smilodonskin Leggings of Maiming	Loot	White Oak Foot Gear Coffer
Smilodonskin Open-toed Boots of Striking	Loot	White Oak Foot Gear Coffer
Smilodonskin Boots of Scouting	Loot	White Oak Foot Gear Coffer
Smilodonskin Open-toed Boots of Aiming	Loot	White Oak Foot Gear Coffer
Smilodonskin Boots of Casting	Loot	White Oak Foot Gear Coffer
Smilodonskin Boots of Healing	Loot	White Oak Foot Gear Coffer
Deepgold Plate Belt of Fending	Loot	White Oak Waist Gear Coffer
Deepgold Plate Belt of Maiming	Loot	White Oak Waist Gear Coffer
Deepgold Plate Belt of Striking	Loot	White Oak Waist Gear Coffer
Deepgold Plate Belt of Scouting	Loot	White Oak Waist Gear Coffer
Deepgold Plate Belt of Aiming	Loot	White Oak Waist Gear Coffer
Deepgold Plate Belt of Casting	Loot	White Oak Waist Gear Coffer
Deepgold Plate Belt of Healing	Loot	White Oak Waist Gear Coffer
Hematite Earrings of Fending	Loot	White Oak Earring Coffer
Hematite Earrings of Slaying	Loot	White Oak Earring Coffer
Hematite Earrings of Aiming	Loot	White Oak Earring Coffer
Hematite Earrings of Casting	Loot	White Oak Earring Coffer
Hematite Earrings of Healing	Loot	White Oak Earring Coffer
Hematite Choker of Fending	Loot	White Oak Necklace Coffer
Hematite Choker of Slaying	Loot	White Oak Necklace Coffer
Hematite Choker of Aiming	Loot	White Oak Necklace Coffer
Hematite Choker of Casting	Loot	White Oak Necklace Coffer
Hematite Choker of Healing	Loot	White Oak Necklace Coffer
Islewolf Bracelet of Fending	Loot	White Oak Bracelet Coffer
Islewolf Bracelet of Slaying	Loot	White Oak Bracelet Coffer
Islewolf Bracelet of Aiming	Loot	White Oak Bracelet Coffer
Islewolf Bracelet of Casting	Loot	White Oak Bracelet Coffer
Islewolf Bracelet of Healing	Loot	White Oak Bracelet Coffer
Islewolf Ring of Fending	Loot	White Oak Ring Coffer
Islewolf Ring of Slaying	Loot	White Oak Ring Coffer
Islewolf Ring of Aiming	Loot	White Oak Ring Coffer
Islewolf Ring of Casting	Loot	White Oak Ring Coffer
Islewolf Ring of Healing	Loot	White Oak Ring Coffer
Deepgold Sword	Loot	Deepgold Weapon Coffer
Deepgold Shield	Loot	Deepgold Weapon Coffer
Deepgold Axe	Loot	Deepgold Weapon Coffer
Deepgold Greatsword	Loot	Deepgold Weapon Coffer
Deepgold Bayonet	Loot	Deepgold Weapon Coffer
Applewood Spear	Loot	Deepgold Weapon Coffer
Deepgold Knuckles	Loot	Deepgold Weapon Coffer
Deepgold Uchigatana	Loot	Deepgold Weapon Coffer
Deepgold Daggers	Loot	Deepgold Weapon Coffer
Applewood Longbow	Loot	Deepgold Weapon Coffer
Deepgold Arquebus	Loot	Deepgold Weapon Coffer
Deepgold Chakrams	Loot	Deepgold Weapon Coffer
Applewood Staff	Loot	Deepgold Weapon Coffer
Gliderskin Grimoire	Loot	Deepgold Weapon Coffer
Stonegold Rapier	Loot	Deepgold Weapon Coffer
Applewood Cane	Loot	Deepgold Weapon Coffer
Gliderskin Codex	Loot	Deepgold Weapon Coffer
Stonegold Orrery	Loot	Deepgold Weapon Coffer
Deepgold Wings of Fending	Loot	Deepgold Head Gear Coffer
Iridescent Hood of Maiming	Loot	Deepgold Head Gear Coffer
Iridescent Hat of Striking	Loot	Deepgold Head Gear Coffer
Iridescent Hat of Scouting	Loot	Deepgold Head Gear Coffer
Iridescent Hat of Aiming	Loot	Deepgold Head Gear Coffer
Iridescent Hat of Casting	Loot	Deepgold Head Gear Coffer
Iridescent Hat of Healing	Loot	Deepgold Head Gear Coffer
Deepgold Mail of Fending	Loot	Deepgold Chest Gear Coffer
Deepgold Surcoat of Maiming	Loot	Deepgold Chest Gear Coffer
Iridescent Acton of Striking	Loot	Deepgold Chest Gear Coffer
Iridescent Acton of Scouting	Loot	Deepgold Chest Gear Coffer
Iridescent Acton of Aiming	Loot	Deepgold Chest Gear Coffer
Iridescent Top of Casting	Loot	Deepgold Chest Gear Coffer
Iridescent Top of Healing	Loot	Deepgold Chest Gear Coffer
Deepgold Gloves of Fending	Loot	Deepgold Hand Gear Coffer
Deepgold Gauntlets of Maiming	Loot	Deepgold Hand Gear Coffer
Gliderskin Gloves of Striking	Loot	Deepgold Hand Gear Coffer
Gliderskin Gloves of Scouting	Loot	Deepgold Hand Gear Coffer
Gliderskin Gloves of Aiming	Loot	Deepgold Hand Gear Coffer
Gliderskin Gloves of Casting	Loot	Deepgold Hand Gear Coffer
Gliderskin Gloves of Healing	Loot	Deepgold Hand Gear Coffer
Gliderskin Breeches of Fending	Loot	Deepgold Leg Gear Coffer
Gliderskin Breeches of Maiming	Loot	Deepgold Leg Gear Coffer
Iridescent Bottoms of Striking	Loot	Deepgold Leg Gear Coffer
Iridescent Bottoms of Scouting	Loot	Deepgold Leg Gear Coffer
Iridescent Bottoms of Aiming	Loot	Deepgold Leg Gear Coffer
Iridescent Bottoms of Casting	Loot	Deepgold Leg Gear Coffer
Iridescent Bottoms of Healing	Loot	Deepgold Leg Gear Coffer
Gliderskin Thighboots of Fending	Loot	Deepgold Foot Gear Coffer
Deepgold Sollerets of Maiming	Loot	Deepgold Foot Gear Coffer
Gliderskin Thighboots of Striking	Loot	Deepgold Foot Gear Coffer
Gliderskin Thighboots of Scouting	Loot	Deepgold Foot Gear Coffer
Gliderskin Boots of Aiming	Loot	Deepgold Foot Gear Coffer
Gliderskin Boots of Casting	Loot	Deepgold Foot Gear Coffer
Gliderskin Boots of Healing	Loot	Deepgold Foot Gear Coffer
Deepgold Tassets of Fending	Loot	Deepgold Waist Gear Coffer
Deepgold Tassets of Maiming	Loot	Deepgold Waist Gear Coffer
Deepgold Tassets of Striking	Loot	Deepgold Waist Gear Coffer
Deepgold Tassets of Scouting	Loot	Deepgold Waist Gear Coffer
Deepgold Tassets of Aiming	Loot	Deepgold Waist Gear Coffer
Deepgold Tassets of Casting	Loot	Deepgold Waist Gear Coffer
Deepgold Tassets of Healing	Loot	Deepgold Waist Gear Coffer
Diaspore Earrings of Fending	Loot	Deepgold Earring Coffer
Diaspore Earrings of Slaying	Loot	Deepgold Earring Coffer
Diaspore Earrings of Aiming	Loot	Deepgold Earring Coffer
Diaspore Earrings of Casting	Loot	Deepgold Earring Coffer
Diaspore Earrings of Healing	Loot	Deepgold Earring Coffer
Diaspore Choker of Fending	Loot	Deepgold Necklace Coffer
Diaspore Choker of Slaying	Loot	Deepgold Necklace Coffer
Diaspore Choker of Aiming	Loot	Deepgold Necklace Coffer
Diaspore Choker of Casting	Loot	Deepgold Necklace Coffer
Diaspore Choker of Healing	Loot	Deepgold Necklace Coffer
Diaspore Bracelet of Fending	Loot	Deepgold Bracelet Coffer
Diaspore Bracelet of Slaying	Loot	Deepgold Bracelet Coffer
Diaspore Bracelet of Aiming	Loot	Deepgold Bracelet Coffer
Diaspore Bracelet of Casting	Loot	Deepgold Bracelet Coffer
Diaspore Bracelet of Healing	Loot	Deepgold Bracelet Coffer
Diaspore Ring of Fending	Loot	Deepgold Ring Coffer
Diaspore Ring of Slaying	Loot	Deepgold Ring Coffer
Diaspore Ring of Aiming	Loot	Deepgold Ring Coffer
Diaspore Ring of Casting	Loot	Deepgold Ring Coffer
Diaspore Ring of Healing	Loot	Deepgold Ring Coffer
Bluespirit Sword	Loot	Bluespirit Weapon Coffer
Bluespirit Tower Shield	Loot	Bluespirit Weapon Coffer
Bluespirit Axe	Loot	Bluespirit Weapon Coffer
Bluespirit Guillotine	Loot	Bluespirit Weapon Coffer
Bluespirit Gunblade	Loot	Bluespirit Weapon Coffer
Bluespirit Spear	Loot	Bluespirit Weapon Coffer
Bluespirit Baghnakhs	Loot	Bluespirit Weapon Coffer
Bluespirit Uchigatana	Loot	Bluespirit Weapon Coffer
Bluespirit Daggers	Loot	Bluespirit Weapon Coffer
Bluespirit Longbow	Loot	Bluespirit Weapon Coffer
Bluespirit Handgonne	Loot	Bluespirit Weapon Coffer
Bluespirit Glaives	Loot	Bluespirit Weapon Coffer
Bluespirit Rod	Loot	Bluespirit Weapon Coffer
Bluespirit Grimoire	Loot	Bluespirit Weapon Coffer
Bluespirit Rapier	Loot	Bluespirit Weapon Coffer
Bluespirit Cane	Loot	Bluespirit Weapon Coffer
Bluespirit Codex	Loot	Bluespirit Weapon Coffer
Bluespirit Star Globe	Loot	Bluespirit Weapon Coffer
Bluespirit Helm of Fending	Loot	Bluespirit Head Gear Coffer
Bluespirit Helm of Maiming	Loot	Bluespirit Head Gear Coffer
Pixie Cotton Hat of Striking	Loot	Bluespirit Head Gear Coffer
Atrociraptorskin Headgear of Scouting	Loot	Bluespirit Head Gear Coffer
Atrociraptorskin Headgear of Aiming	Loot	Bluespirit Head Gear Coffer
Bluespirit Headgear of Casting	Loot	Bluespirit Head Gear Coffer
Pixie Cotton Hood of Healing	Loot	Bluespirit Head Gear Coffer
Bluespirit Cuirass of Fending	Loot	Bluespirit Chest Gear Coffer
Bluespirit Cuirass of Maiming	Loot	Bluespirit Chest Gear Coffer
Pixie Cotton Acton of Striking	Loot	Bluespirit Chest Gear Coffer
Atrociraptorskin Corselet of Scouting	Loot	Bluespirit Chest Gear Coffer
Atrociraptorskin Corselet of Aiming	Loot	Bluespirit Chest Gear Coffer
Atrociraptorskin Coat of Casting	Loot	Bluespirit Chest Gear Coffer
Pixie Cotton Robe of Healing	Loot	Bluespirit Chest Gear Coffer
Bluespirit Gauntlets of Fending	Loot	Bluespirit Hand Gear Coffer
Bluespirit Gauntlets of Maiming	Loot	Bluespirit Hand Gear Coffer
Pixie Cotton Sleeves of Striking	Loot	Bluespirit Hand Gear Coffer
Atrociraptorskin Armguard of Scouting	Loot	Bluespirit Hand Gear Coffer
Atrociraptorskin Armguard of Aiming	Loot	Bluespirit Hand Gear Coffer
Atrociraptorskin Bracers of Casting	Loot	Bluespirit Hand Gear Coffer
Atrociraptorskin Armguards of Healing	Loot	Bluespirit Hand Gear Coffer
Atrociraptorskin Breeches of Fending	Loot	Bluespirit Leg Gear Coffer
Atrociraptorskin Breeches of Maiming	Loot	Bluespirit Leg Gear Coffer
Pixie Cotton Culottes of Striking	Loot	Bluespirit Leg Gear Coffer
Pixie Cotton Brais of Scouting	Loot	Bluespirit Leg Gear Coffer
Pixie Cotton Brais of Aiming	Loot	Bluespirit Leg Gear Coffer
Pixie Cotton Slops of Casting	Loot	Bluespirit Leg Gear Coffer
Pixie Cotton Slops of Healing	Loot	Bluespirit Leg Gear Coffer
Bluespirit Sabatons of Fending	Loot	Bluespirit Foot Gear Coffer
Bluespirit Sabatons of Maiming	Loot	Bluespirit Foot Gear Coffer
Atrociraptorskin Thighboots of Striking	Loot	Bluespirit Foot Gear Coffer
Atrociraptorskin Leg Guards of Scouting	Loot	Bluespirit Foot Gear Coffer
Atrociraptorskin Leg Guards of Aiming	Loot	Bluespirit Foot Gear Coffer
Bluespirit Greaves of Casting	Loot	Bluespirit Foot Gear Coffer
Atrociraptorskin Boots of Healing	Loot	Bluespirit Foot Gear Coffer
Bluespirit Plate Belt of Fending	Loot	Bluespirit Waist Gear Coffer
Bluespirit Plate Belt of Maiming	Loot	Bluespirit Waist Gear Coffer
Bluespirit Plate Belt of Striking	Loot	Bluespirit Waist Gear Coffer
Bluespirit Plate Belt of Scouting	Loot	Bluespirit Waist Gear Coffer
Bluespirit Plate Belt of Aiming	Loot	Bluespirit Waist Gear Coffer
Bluespirit Plate Belt of Casting	Loot	Bluespirit Waist Gear Coffer
Bluespirit Plate Belt of Healing	Loot	Bluespirit Waist Gear Coffer
White Ash Earring of Fending	Loot	Bluespirit Earring Coffer
White Ash Earring of Slaying	Loot	Bluespirit Earring Coffer
White Ash Earring of Aiming	Loot	Bluespirit Earring Coffer
White Ash Earring of Casting	Loot	Bluespirit Earring Coffer
White Ash Earring of Healing	Loot	Bluespirit Earring Coffer
Atrociraptorskin Necklace of Fending	Loot	Bluespirit Necklace Coffer
Atrociraptorskin Necklace of Slaying	Loot	Bluespirit Necklace Coffer
Atrociraptorskin Necklace of Aiming	Loot	Bluespirit Necklace Coffer
Atrociraptorskin Necklace of Casting	Loot	Bluespirit Necklace Coffer
Atrociraptorskin Necklace of Healing	Loot	Bluespirit Necklace Coffer
Atrociraptorskin Amulet of Fending	Loot	Bluespirit Bracelet Coffer
Atrociraptorskin Amulet of Slaying	Loot	Bluespirit Bracelet Coffer
Atrociraptorskin Amulet of Aiming	Loot	Bluespirit Bracelet Coffer
Atrociraptorskin Amulet of Casting	Loot	Bluespirit Bracelet Coffer
Atrociraptorskin Amulet of Healing	Loot	Bluespirit Bracelet Coffer
Lazurite Ring of Fending	Loot	Bluespirit Ring Coffer
Lazurite Ring of Slaying	Loot	Bluespirit Ring Coffer
Lazurite Ring of Aiming	Loot	Bluespirit Ring Coffer
Lazurite Ring of Casting	Loot	Bluespirit Ring Coffer
Lazurite Ring of Healing	Loot	Bluespirit Ring Coffer
Titanbronze Kilij	Loot	Titanbronze Weapon Coffer
Titanbronze Tower Shield	Loot	Titanbronze Weapon Coffer
Titanbronze Battleaxe	Loot	Titanbronze Weapon Coffer
Titanbronze Guillotine	Loot	Titanbronze Weapon Coffer
Titanbronze Bayonet	Loot	Titanbronze Weapon Coffer
Sandteak Fauchard	Loot	Titanbronze Weapon Coffer
Titanbronze Fists	Loot	Titanbronze Weapon Coffer
Titanbronze Uchigatana	Loot	Titanbronze Weapon Coffer
Titanbronze Daggers	Loot	Titanbronze Weapon Coffer
Sandteak Longbow	Loot	Titanbronze Weapon Coffer
Titanbronze Musketoon	Loot	Titanbronze Weapon Coffer
Titanbronze Chakrams	Loot	Titanbronze Weapon Coffer
Sandteak Rod	Loot	Titanbronze Weapon Coffer
Zonureskin Grimoire	Loot	Titanbronze Weapon Coffer
Titanbronze Rapier	Loot	Titanbronze Weapon Coffer
Sandteak Cane	Loot	Titanbronze Weapon Coffer
Zonureskin Codex	Loot	Titanbronze Weapon Coffer
Titanbronze Star Globe	Loot	Titanbronze Weapon Coffer
Titanbronze Headgear of Fending	Loot	Titanbronze Head Gear Coffer
Titanbronze Headgear of Maiming	Loot	Titanbronze Head Gear Coffer
Ovim Wool Ushanka of Striking	Loot	Titanbronze Head Gear Coffer
Titanbronze Headband of Scouting	Loot	Titanbronze Head Gear Coffer
Ovim Wool Ushanka of Aiming	Loot	Titanbronze Head Gear Coffer
Ovim Wool Muffed Met of Casting	Loot	Titanbronze Head Gear Coffer
Ovim Wool Muffed Met of Healing	Loot	Titanbronze Head Gear Coffer
Zonureskin Coat of Fending	Loot	Titanbronze Chest Gear Coffer
Zonureskin Coat of Maiming	Loot	Titanbronze Chest Gear Coffer
Ovim Wool Coat of Striking	Loot	Titanbronze Chest Gear Coffer
Ovim Wool Jacket of Scouting	Loot	Titanbronze Chest Gear Coffer
Ovim Wool Tunic of Aiming	Loot	Titanbronze Chest Gear Coffer
Ovim Wool Tunic of Casting	Loot	Titanbronze Chest Gear Coffer
Ovim Wool Coat of Healing	Loot	Titanbronze Chest Gear Coffer
Zonureskin Fingerless Gloves of Fending	Loot	Titanbronze Hand Gear Coffer
Zonureskin Fingerless Gloves of Maiming	Loot	Titanbronze Hand Gear Coffer
Zonureskin Fingerless Gloves of Striking	Loot	Titanbronze Hand Gear Coffer
Zonureskin Fingerless Gloves of Scouting	Loot	Titanbronze Hand Gear Coffer
Zonureskin Fingerless Gloves of Aiming	Loot	Titanbronze Hand Gear Coffer
Zonureskin Fingerless Gloves of Casting	Loot	Titanbronze Hand Gear Coffer
Zonureskin Fingerless Gloves of Healing	Loot	Titanbronze Hand Gear Coffer
Ovim Wool Bottoms of Fending	Loot	Titanbronze Leg Gear Coffer
Ovim Wool Bottoms of Maiming	Loot	Titanbronze Leg Gear Coffer
Ovim Wool Skirt of Striking	Loot	Titanbronze Leg Gear Coffer
Ovim Wool Bottoms of Scouting	Loot	Titanbronze Leg Gear Coffer
Ovim Wool Bottoms of Aiming	Loot	Titanbronze Leg Gear Coffer
Ovim Wool Bottoms of Casting	Loot	Titanbronze Leg Gear Coffer
Ovim Wool Skirt of Healing	Loot	Titanbronze Leg Gear Coffer
Zonureskin Caligae of Fending	Loot	Titanbronze Foot Gear Coffer
Zonureskin Caligae of Maiming	Loot	Titanbronze Foot Gear Coffer
Zonureskin Caligae of Striking	Loot	Titanbronze Foot Gear Coffer
Zonureskin Caligae of Scouting	Loot	Titanbronze Foot Gear Coffer
Zonureskin Sandals of Aiming	Loot	Titanbronze Foot Gear Coffer
Zonureskin Sandals of Casting	Loot	Titanbronze Foot Gear Coffer
Zonureskin Caligae of Healing	Loot	Titanbronze Foot Gear Coffer
Titanbronze Tassets of Fending	Loot	Titanbronze Waist Gear Coffer
Titanbronze Tassets of Maiming	Loot	Titanbronze Waist Gear Coffer
Titanbronze Tassets of Striking	Loot	Titanbronze Waist Gear Coffer
Titanbronze Tassets of Scouting	Loot	Titanbronze Waist Gear Coffer
Titanbronze Tassets of Aiming	Loot	Titanbronze Waist Gear Coffer
Titanbronze Tassets of Casting	Loot	Titanbronze Waist Gear Coffer
Titanbronze Tassets of Healing	Loot	Titanbronze Waist Gear Coffer
Triplite Earrings of Fending	Loot	Titanbronze Earring Coffer
Triplite Earrings of Slaying	Loot	Titanbronze Earring Coffer
Triplite Earrings of Aiming	Loot	Titanbronze Earring Coffer
Triplite Earrings of Casting	Loot	Titanbronze Earring Coffer
Triplite Earrings of Healing	Loot	Titanbronze Earring Coffer
Triplite Choker of Fending	Loot	Titanbronze Necklace Coffer
Triplite Choker of Slaying	Loot	Titanbronze Necklace Coffer
Triplite Choker of Aiming	Loot	Titanbronze Necklace Coffer
Triplite Choker of Casting	Loot	Titanbronze Necklace Coffer
Triplite Choker of Healing	Loot	Titanbronze Necklace Coffer
Triplite Bracelet of Fending	Loot	Titanbronze Bracelet Coffer
Triplite Bracelet of Slaying	Loot	Titanbronze Bracelet Coffer
Triplite Bracelet of Aiming	Loot	Titanbronze Bracelet Coffer
Triplite Bracelet of Casting	Loot	Titanbronze Bracelet Coffer
Triplite Bracelet of Healing	Loot	Titanbronze Bracelet Coffer
Triplite Ring of Fending	Loot	Titanbronze Ring Coffer
Triplite Ring of Slaying	Loot	Titanbronze Ring Coffer
Triplite Ring of Aiming	Loot	Titanbronze Ring Coffer
Triplite Ring of Casting	Loot	Titanbronze Ring Coffer
Triplite Ring of Healing	Loot	Titanbronze Ring Coffer
Dwarven Mythril Pikenstock	Loot	High Mythril Weapon Coffer
Dwarven Mythril Shield	Loot	High Mythril Weapon Coffer
Dwarven Mythril Hammer	Loot	High Mythril Weapon Coffer
Dwarven Mythril Guillotine	Loot	High Mythril Weapon Coffer
Dwarven Mythril Manatrigger	Loot	High Mythril Weapon Coffer
Dwarven Lignum Lance	Loot	High Mythril Weapon Coffer
Dwarven Mythril Knuckles	Loot	High Mythril Weapon Coffer
Dwarven Mythril Uchigatana	Loot	High Mythril Weapon Coffer
Dwarven Mythril Rotaries	Loot	High Mythril Weapon Coffer
Dwarven Lignum Bow	Loot	High Mythril Weapon Coffer
Dwarven Mythril Pistol	Loot	High Mythril Weapon Coffer
Dwarven Mythril Glaives	Loot	High Mythril Weapon Coffer
Dwarven Lignum Pole	Loot	High Mythril Weapon Coffer
Dwarven Mythril Grimoire	Loot	High Mythril Weapon Coffer
Dwarven Mythril Rapier	Loot	High Mythril Weapon Coffer
Dwarven Lignum Cane	Loot	High Mythril Weapon Coffer
Dwarven Mythril Codex	Loot	High Mythril Weapon Coffer
Dwarven Mythril Planisphere	Loot	High Mythril Weapon Coffer
Dwarven Mythril Helm of Fending	Loot	High Mythril Head Gear Coffer
Dwarven Mythril Helm of Maiming	Loot	High Mythril Head Gear Coffer
Dwarven Mythril Helm of Striking	Loot	High Mythril Head Gear Coffer
Dwarven Cotton Turban of Scouting	Loot	High Mythril Head Gear Coffer
Dwarven Cotton Turban of Aiming	Loot	High Mythril Head Gear Coffer
Dwarven Cotton Petasos of Casting	Loot	High Mythril Head Gear Coffer
Dwarven Cotton Petasos of Healing	Loot	High Mythril Head Gear Coffer
Dwarven Mythril Chainmail of Fending	Loot	High Mythril Chest Gear Coffer
Dwarven Mythril Chainmail of Maiming	Loot	High Mythril Chest Gear Coffer
Dwarven Mythril Chainmail of Striking	Loot	High Mythril Chest Gear Coffer
Swallowskin Jacket of Scouting	Loot	High Mythril Chest Gear Coffer
Swallowskin Robe of Aiming	Loot	High Mythril Chest Gear Coffer
Swallowskin Robe of Casting	Loot	High Mythril Chest Gear Coffer
Swallowskin Robe of Healing	Loot	High Mythril Chest Gear Coffer
Swallowskin Gloves of Fending	Loot	High Mythril Hand Gear Coffer
Swallowskin Gloves of Maiming	Loot	High Mythril Hand Gear Coffer
Swallowskin Gloves of Striking	Loot	High Mythril Hand Gear Coffer
Swallowskin Gloves of Scouting	Loot	High Mythril Hand Gear Coffer
Swallowskin Gloves of Aiming	Loot	High Mythril Hand Gear Coffer
Swallowskin Gloves of Casting	Loot	High Mythril Hand Gear Coffer
Swallowskin Gloves of Healing	Loot	High Mythril Hand Gear Coffer
Dwarven Cotton Gaskins of Fending	Loot	High Mythril Leg Gear Coffer
Dwarven Cotton Gaskins of Maiming	Loot	High Mythril Leg Gear Coffer
Dwarven Cotton Gaskins of Striking	Loot	High Mythril Leg Gear Coffer
Dwarven Cotton Gaskins of Scouting	Loot	High Mythril Leg Gear Coffer
Dwarven Cotton Gaskins of Aiming	Loot	High Mythril Leg Gear Coffer
Dwarven Cotton Gaskins of Casting	Loot	High Mythril Leg Gear Coffer
Dwarven Cotton Gaskins of Healing	Loot	High Mythril Leg Gear Coffer
Dwarven Mythril Shoes of Fending	Loot	High Mythril Foot Gear Coffer
Dwarven Mythril Shoes of Maiming	Loot	High Mythril Foot Gear Coffer
Swallowskin Shoes of Striking	Loot	High Mythril Foot Gear Coffer
Dwarven Mythril Shoes of Scouting	Loot	High Mythril Foot Gear Coffer
Dwarven Mythril Shoes of Aiming	Loot	High Mythril Foot Gear Coffer
Swallowskin Shoes of Casting	Loot	High Mythril Foot Gear Coffer
Swallowskin Shoes of Healing	Loot	High Mythril Foot Gear Coffer
Dwarven Mythril Plate Belt of Fending	Loot	High Mythril Waist Gear Coffer
Dwarven Mythril Plate Belt of Maiming	Loot	High Mythril Waist Gear Coffer
Dwarven Mythril Plate Belt of Striking	Loot	High Mythril Waist Gear Coffer
Dwarven Mythril Plate Belt of Scouting	Loot	High Mythril Waist Gear Coffer
Dwarven Mythril Plate Belt of Aiming	Loot	High Mythril Waist Gear Coffer
Dwarven Mythril Plate Belt of Casting	Loot	High Mythril Waist Gear Coffer
Dwarven Mythril Plate Belt of Healing	Loot	High Mythril Waist Gear Coffer
Petalite Earrings of Fending	Loot	High Mythril Earring Coffer
Petalite Earrings of Slaying	Loot	High Mythril Earring Coffer
Petalite Earrings of Aiming	Loot	High Mythril Earring Coffer
Petalite Earrings of Casting	Loot	High Mythril Earring Coffer
Petalite Earrings of Healing	Loot	High Mythril Earring Coffer
Petalite Choker of Fending	Loot	High Mythril Necklace Coffer
Petalite Choker of Slaying	Loot	High Mythril Necklace Coffer
Petalite Choker of Aiming	Loot	High Mythril Necklace Coffer
Petalite Choker of Casting	Loot	High Mythril Necklace Coffer
Petalite Choker of Healing	Loot	High Mythril Necklace Coffer
Petalite Bracelet of Fending	Loot	High Mythril Bracelet Coffer
Petalite Bracelet of Slaying	Loot	High Mythril Bracelet Coffer
Petalite Bracelet of Aiming	Loot	High Mythril Bracelet Coffer
Petalite Bracelet of Casting	Loot	High Mythril Bracelet Coffer
Petalite Bracelet of Healing	Loot	High Mythril Bracelet Coffer
Petalite Ring of Fending	Loot	High Mythril Ring Coffer
Petalite Ring of Slaying	Loot	High Mythril Ring Coffer
Petalite Ring of Aiming	Loot	High Mythril Ring Coffer
Petalite Ring of Casting	Loot	High Mythril Ring Coffer
Petalite Ring of Healing	Loot	High Mythril Ring Coffer
Dai-ryumyaku Hachigane of Fending	Loot	Dai-ryumyaku Armor of Fending Coffer
Dai-ryumyaku Jufuku of Fending	Loot	Dai-ryumyaku Armor of Fending Coffer
Dai-ryumyaku Kote of Fending	Loot	Dai-ryumyaku Armor of Fending Coffer
Dai-ryumyaku Obi of Fending	Loot	Dai-ryumyaku Armor of Fending Coffer
Dai-ryumyaku Jui of Fending	Loot	Dai-ryumyaku Armor of Fending Coffer
Dai-ryumyaku Sune-ate of Fending	Loot	Dai-ryumyaku Armor of Fending Coffer
Dai-ryumyaku Hachigane of Maiming	Loot	Dai-ryumyaku Armor of Maiming Coffer
Dai-ryumyaku Jufuku of Maiming	Loot	Dai-ryumyaku Armor of Maiming Coffer
Dai-ryumyaku Kote of Maiming	Loot	Dai-ryumyaku Armor of Maiming Coffer
Dai-ryumyaku Obi of Maiming	Loot	Dai-ryumyaku Armor of Maiming Coffer
Dai-ryumyaku Tsutsu-hakama of Maiming	Loot	Dai-ryumyaku Armor of Maiming Coffer
Dai-ryumyaku Sune-ate of Maiming	Loot	Dai-ryumyaku Armor of Maiming Coffer
Dai-ryumyaku Hachigane of Striking	Loot	Dai-ryumyaku Armor of Striking Coffer
Dai-ryumyaku Togi of Striking	Loot	Dai-ryumyaku Armor of Striking Coffer
Dai-ryumyaku Kote of Striking	Loot	Dai-ryumyaku Armor of Striking Coffer
Dai-ryumyaku Obi of Striking	Loot	Dai-ryumyaku Armor of Striking Coffer
Dai-ryumyaku Tsutsu-hakama of Striking	Loot	Dai-ryumyaku Armor of Striking Coffer
Dai-ryumyaku Sune-ate of Striking	Loot	Dai-ryumyaku Armor of Striking Coffer
Dai-ryumyaku Hachigane of Aiming	Loot	Dai-ryumyaku Armor of Aiming Coffer
Dai-ryumyaku Jufuku of Aiming	Loot	Dai-ryumyaku Armor of Aiming Coffer
Dai-ryumyaku Kote of Aiming	Loot	Dai-ryumyaku Armor of Aiming Coffer
Dai-ryumyaku Obi of Aiming	Loot	Dai-ryumyaku Armor of Aiming Coffer
Dai-ryumyaku Jui of Aiming	Loot	Dai-ryumyaku Armor of Aiming Coffer
Dai-ryumyaku Sune-ate of Aiming	Loot	Dai-ryumyaku Armor of Aiming Coffer
Dai-ryumyaku Hachigane of Scouting	Loot	Dai-ryumyaku Armor of Scouting Coffer
Dai-ryumyaku Togi of Scouting	Loot	Dai-ryumyaku Armor of Scouting Coffer
Dai-ryumyaku Kote of Scouting	Loot	Dai-ryumyaku Armor of Scouting Coffer
Dai-ryumyaku Obi of Scouting	Loot	Dai-ryumyaku Armor of Scouting Coffer
Dai-ryumyaku Tsutsu-hakama of Scouting	Loot	Dai-ryumyaku Armor of Scouting Coffer
Dai-ryumyaku Sune-ate of Scouting	Loot	Dai-ryumyaku Armor of Scouting Coffer
Dai-ryumyaku Seibo of Casting	Loot	Dai-ryumyaku Armor of Casting Coffer
Dai-ryumyaku Dogi of Casting	Loot	Dai-ryumyaku Armor of Casting Coffer
Dai-ryumyaku Kote of Casting	Loot	Dai-ryumyaku Armor of Casting Coffer
Dai-ryumyaku Obi of Casting	Loot	Dai-ryumyaku Armor of Casting Coffer
Dai-ryumyaku Tsutsu-hakama of Casting	Loot	Dai-ryumyaku Armor of Casting Coffer
Dai-ryumyaku Choka of Casting	Loot	Dai-ryumyaku Armor of Casting Coffer
Dai-ryumyaku Hitai-ate of Healing	Loot	Dai-ryumyaku Armor of Healing Coffer
Dai-ryumyaku Dogi of Healing	Loot	Dai-ryumyaku Armor of Healing Coffer
Dai-ryumyaku Kote of Healing	Loot	Dai-ryumyaku Armor of Healing Coffer
Dai-ryumyaku Obi of Healing	Loot	Dai-ryumyaku Armor of Healing Coffer
Dai-ryumyaku Tsutsu-hakama of Healing	Loot	Dai-ryumyaku Armor of Healing Coffer
Dai-ryumyaku Choka of Healing	Loot	Dai-ryumyaku Armor of Healing Coffer
Dai-ryumyaku Earring of Fending	Loot	Dai-ryumyaku Accessories of Fending Coffer
Dai-ryumyaku Necklace of Fending	Loot	Dai-ryumyaku Accessories of Fending Coffer
Dai-ryumyaku Bracelet of Fending	Loot	Dai-ryumyaku Accessories of Fending Coffer
Dai-ryumyaku Ring of Fending	Loot	Dai-ryumyaku Accessories of Fending Coffer
Dai-ryumyaku Earring of Slaying	Loot	Dai-ryumyaku Accessories of Slaying Coffer
Dai-ryumyaku Necklace of Slaying	Loot	Dai-ryumyaku Accessories of Slaying Coffer
Dai-ryumyaku Bracelet of Slaying	Loot	Dai-ryumyaku Accessories of Slaying Coffer
Dai-ryumyaku Ring of Slaying	Loot	Dai-ryumyaku Accessories of Slaying Coffer
Dai-ryumyaku Earring of Aiming	Loot	Dai-ryumyaku Accessories of Aiming Coffer
Dai-ryumyaku Necklace of Aiming	Loot	Dai-ryumyaku Accessories of Aiming Coffer
Dai-ryumyaku Bracelet of Aiming	Loot	Dai-ryumyaku Accessories of Aiming Coffer
Dai-ryumyaku Ring of Aiming	Loot	Dai-ryumyaku Accessories of Aiming Coffer
Dai-ryumyaku Earring of Casting	Loot	Dai-ryumyaku Accessories of Casting Coffer
Dai-ryumyaku Necklace of Casting	Loot	Dai-ryumyaku Accessories of Casting Coffer
Dai-ryumyaku Bracelet of Casting	Loot	Dai-ryumyaku Accessories of Casting Coffer
Dai-ryumyaku Ring of Casting	Loot	Dai-ryumyaku Accessories of Casting Coffer
Dai-ryumyaku Earring of Healing	Loot	Dai-ryumyaku Accessories of Healing Coffer
Dai-ryumyaku Necklace of Healing	Loot	Dai-ryumyaku Accessories of Healing Coffer
Dai-ryumyaku Bracelet of Healing	Loot	Dai-ryumyaku Accessories of Healing Coffer
Dai-ryumyaku Ring of Healing	Loot	Dai-ryumyaku Accessories of Healing Coffer
Homura Kai	Loot	Dai-ryumyaku Weapon Coffer
Mitsuba Kai	Loot	Dai-ryumyaku Weapon Coffer
Mikazuki Kai	Loot	Dai-ryumyaku Weapon Coffer
Odenta Kai	Loot	Dai-ryumyaku Weapon Coffer
Yaita Kai	Loot	Dai-ryumyaku Weapon Coffer
Otegine Kai	Loot	Dai-ryumyaku Weapon Coffer
Jikki Kai	Loot	Dai-ryumyaku Weapon Coffer
Kanesada Kai	Loot	Dai-ryumyaku Weapon Coffer
Niokiyotsuna Kai	Loot	Dai-ryumyaku Weapon Coffer
Kujakuo Kai	Loot	Dai-ryumyaku Weapon Coffer
Ikkansai Kai	Loot	Dai-ryumyaku Weapon Coffer
Gyosei Kai	Loot	Dai-ryumyaku Weapon Coffer
Makibi Kai	Loot	Dai-ryumyaku Weapon Coffer
Kinyoshu Kai	Loot	Dai-ryumyaku Weapon Coffer
Shishio Kai	Loot	Dai-ryumyaku Weapon Coffer
Byakurenge Kai	Loot	Dai-ryumyaku Weapon Coffer
Koyoshu Kai	Loot	Dai-ryumyaku Weapon Coffer
Kontengi Kai	Loot	Dai-ryumyaku Weapon Coffer
Augmented Scaevan Ear Cuff of Fending	Loot	Scaevan Accessories of Fending Coffer
Augmented Scaevan Choker of Fending	Loot	Scaevan Accessories of Fending Coffer
Augmented Scaevan Bracelet of Fending	Loot	Scaevan Accessories of Fending Coffer
Augmented Scaevan Ring of Fending	Loot	Scaevan Accessories of Fending Coffer
Alliance Ring of Fending	Loot	Scaevan Accessories of Fending Coffer
Augmented Scaevan Ear Cuff of Slaying	Loot	Scaevan Accessories of Slaying Coffer
Augmented Scaevan Choker of Slaying	Loot	Scaevan Accessories of Slaying Coffer
Augmented Scaevan Bracelet of Slaying	Loot	Scaevan Accessories of Slaying Coffer
Augmented Scaevan Ring of Slaying	Loot	Scaevan Accessories of Slaying Coffer
Alliance Ring of Slaying	Loot	Scaevan Accessories of Slaying Coffer
Augmented Scaevan Ear Cuff of Aiming	Loot	Scaevan Accessories of Aiming Coffer
Augmented Scaevan Choker of Aiming	Loot	Scaevan Accessories of Aiming Coffer
Augmented Scaevan Bracelet of Aiming	Loot	Scaevan Accessories of Aiming Coffer
Augmented Scaevan Ring of Aiming	Loot	Scaevan Accessories of Aiming Coffer
Alliance Ring of Aiming	Loot	Scaevan Accessories of Aiming Coffer
Augmented Scaevan Ear Cuff of Casting	Loot	Scaevan Accessories of Casting Coffer
Augmented Scaevan Choker of Casting	Loot	Scaevan Accessories of Casting Coffer
Augmented Scaevan Bracelet of Casting	Loot	Scaevan Accessories of Casting Coffer
Augmented Scaevan Ring of Casting	Loot	Scaevan Accessories of Casting Coffer
Alliance Ring of Casting	Loot	Scaevan Accessories of Casting Coffer
Augmented Scaevan Ear Cuff of Healing	Loot	Scaevan Accessories of Healing Coffer
Augmented Scaevan Choker of Healing	Loot	Scaevan Accessories of Healing Coffer
Augmented Scaevan Bracelet of Healing	Loot	Scaevan Accessories of Healing Coffer
Augmented Scaevan Ring of Healing	Loot	Scaevan Accessories of Healing Coffer
Alliance Ring of Healing	Loot	Scaevan Accessories of Healing Coffer
Idealized Chevalier's Temple Chain	Loot	Idealized Head Gear Coffer
Idealized Bhikku Knotcap	Loot	Idealized Head Gear Coffer
Idealized Boii Burgeonet	Loot	Idealized Head Gear Coffer
Idealized Pteroslaver Armet	Loot	Idealized Head Gear Coffer
Idealized Fili Chapeau	Loot	Idealized Head Gear Coffer
Idealized Ebers Hood	Loot	Idealized Head Gear Coffer
Idealized Wicce Petasos	Loot	Idealized Head Gear Coffer
Idealized Beckoner's Horn	Loot	Idealized Head Gear Coffer
Idealized Arbatel Mortarboard	Loot	Idealized Head Gear Coffer
Idealized Hattori Somen	Loot	Idealized Head Gear Coffer
Idealized Bale Burgeonet	Loot	Idealized Head Gear Coffer
Idealized Gunslinger's Hat	Loot	Idealized Head Gear Coffer
Idealized Soothsayer's Turban	Loot	Idealized Head Gear Coffer
Idealized Kasuga Hanbo	Loot	Idealized Head Gear Coffer
Idealized Estoqueur's Tricorne	Loot	Idealized Head Gear Coffer
Idealized Bodyguard's Blinder	Loot	Idealized Head Gear Coffer
Idealized Dancer's Headdress	Loot	Idealized Head Gear Coffer
Idealized Chevalier's Cuirass	Loot	Idealized Chest Gear Coffer
Idealized Bhikku Cyclas	Loot	Idealized Chest Gear Coffer
Idealized Boii Tunic	Loot	Idealized Chest Gear Coffer
Idealized Pteroslaver Mail	Loot	Idealized Chest Gear Coffer
Idealized Fili Gilet	Loot	Idealized Chest Gear Coffer
Idealized Ebers Robe	Loot	Idealized Chest Gear Coffer
Idealized Wicce Coat	Loot	Idealized Chest Gear Coffer
Idealized Beckoner's Coat	Loot	Idealized Chest Gear Coffer
Idealized Arbatel Cloak	Loot	Idealized Chest Gear Coffer
Idealized Hattori Chainmail	Loot	Idealized Chest Gear Coffer
Idealized Bale Cuirass	Loot	Idealized Chest Gear Coffer
Idealized Gunslinger's Coat	Loot	Idealized Chest Gear Coffer
Idealized Soothsayer's Chiton	Loot	Idealized Chest Gear Coffer
Idealized Kasuga Haori	Loot	Idealized Chest Gear Coffer
Idealized Estoqueur's Bliaud	Loot	Idealized Chest Gear Coffer
Idealized Bodyguard's Coat	Loot	Idealized Chest Gear Coffer
Idealized Dancer's Casaque	Loot	Idealized Chest Gear Coffer
Idealized Chevalier's Gauntlets	Loot	Idealized Hand Gear Coffer
Idealized Bhikku Gloves	Loot	Idealized Hand Gear Coffer
Idealized Boii Gauntlets	Loot	Idealized Hand Gear Coffer
Idealized Pteroslaver Gauntlets	Loot	Idealized Hand Gear Coffer
Idealized Fili Armlets	Loot	Idealized Hand Gear Coffer
Idealized Ebers Armlets	Loot	Idealized Hand Gear Coffer
Idealized Wicce Wrist Torque	Loot	Idealized Hand Gear Coffer
Idealized Beckoner's Fingerless Gloves	Loot	Idealized Hand Gear Coffer
Idealized Arbatel Gloves	Loot	Idealized Hand Gear Coffer
Idealized Hattori Tekko	Loot	Idealized Hand Gear Coffer
Idealized Bale Gauntlets	Loot	Idealized Hand Gear Coffer
Idealized Gunslinger's Halfgloves	Loot	Idealized Hand Gear Coffer
Idealized Soothsayer's Armlets	Loot	Idealized Hand Gear Coffer
Idealized Kasuga Kote	Loot	Idealized Hand Gear Coffer
Idealized Estoqueur's Gloves	Loot	Idealized Hand Gear Coffer
Idealized Bodyguard's Fingerless Gloves	Loot	Idealized Hand Gear Coffer
Idealized Dancer's Armlets	Loot	Idealized Hand Gear Coffer
Idealized Chevalier's Poleyns	Loot	Idealized Leg Gear Coffer
Idealized Bhikku Poleyns	Loot	Idealized Leg Gear Coffer
Idealized Boii Brais	Loot	Idealized Leg Gear Coffer
Idealized Pteroslaver Subligar	Loot	Idealized Leg Gear Coffer
Idealized Fili Bottoms	Loot	Idealized Leg Gear Coffer
Idealized Ebers Skirt	Loot	Idealized Leg Gear Coffer
Idealized Wicce Bottoms	Loot	Idealized Leg Gear Coffer
Idealized Beckoner's Sarouel	Loot	Idealized Leg Gear Coffer
Idealized Arbatel Bottoms	Loot	Idealized Leg Gear Coffer
Idealized Hattori Trousers	Loot	Idealized Leg Gear Coffer
Idealized Bale Flanchard	Loot	Idealized Leg Gear Coffer
Idealized Gunslinger's Bottoms	Loot	Idealized Leg Gear Coffer
Idealized Soothsayer's Skirt	Loot	Idealized Leg Gear Coffer
Idealized Kasuga Tsutsu-hakama	Loot	Idealized Leg Gear Coffer
Idealized Estoqueur's Bottoms	Loot	Idealized Leg Gear Coffer
Idealized Bodyguard's Trousers	Loot	Idealized Leg Gear Coffer
Idealized Dancer's Bottoms	Loot	Idealized Leg Gear Coffer
Idealized Chevalier's Sollerets	Loot	Idealized Foot Gear Coffer
Idealized Bhikku Boots	Loot	Idealized Foot Gear Coffer
Idealized Boii Boots	Loot	Idealized Foot Gear Coffer
Idealized Pteroslaver Greaves	Loot	Idealized Foot Gear Coffer
Idealized Fili Shoes	Loot	Idealized Foot Gear Coffer
Idealized Ebers Thighboots	Loot	Idealized Foot Gear Coffer
Idealized Wicce Shoes	Loot	Idealized Foot Gear Coffer
Idealized Beckoner's Crakows	Loot	Idealized Foot Gear Coffer
Idealized Arbatel Thighboots	Loot	Idealized Foot Gear Coffer
Idealized Hattori Kyahan	Loot	Idealized Foot Gear Coffer
Idealized Bale Sollerets	Loot	Idealized Foot Gear Coffer
Idealized Gunslinger's Thighboots	Loot	Idealized Foot Gear Coffer
Idealized Soothsayer's Sandals	Loot	Idealized Foot Gear Coffer
Idealized Kasuga Zori	Loot	Idealized Foot Gear Coffer
Idealized Estoqueur's Thighboots	Loot	Idealized Foot Gear Coffer
Idealized Bodyguard's Thighboots	Loot	Idealized Foot Gear Coffer
Idealized Dancer's Shoes	Loot	Idealized Foot Gear Coffer
Carnage Sword	Loot	Level 18 Weapon Coffer
Iron Lantern Shield	Loot	Level 18 Weapon Coffer
Inferno Axe	Loot	Level 18 Weapon Coffer
Iron Lance	Loot	Level 18 Weapon Coffer
Hard Leather Cesti	Loot	Level 18 Weapon Coffer
Iron Daggers	Loot	Level 18 Weapon Coffer
Elm Longbow	Loot	Level 18 Weapon Coffer
Staghorn Staff	Loot	Level 18 Weapon Coffer
Engraved Hard Leather Grimoire	Loot	Level 18 Weapon Coffer
Elm Crook	Loot	Level 18 Weapon Coffer
Iron Shortsword	Loot	Level 21 Weapon Coffer
Iron Scutum	Loot	Level 21 Weapon Coffer
Iron Bill	Loot	Level 21 Weapon Coffer
Iron Guisarme	Loot	Level 21 Weapon Coffer
Spiked Knuckles	Loot	Level 21 Weapon Coffer
Iron Pugiones	Loot	Level 21 Weapon Coffer
Elm Velocity Bow	Loot	Level 21 Weapon Coffer
Sanguine Horn Staff	Loot	Level 21 Weapon Coffer
Yew Picatrix	Loot	Level 21 Weapon Coffer
Pastoral Yew Cane	Loot	Level 21 Weapon Coffer
Steel Broadsword	Loot	Level 24 Weapon Coffer
Viper-crested Round Shield	Loot	Level 24 Weapon Coffer
Thunderstorm Axe	Loot	Level 24 Weapon Coffer
Silver Battle Fork	Loot	Level 24 Weapon Coffer
Toadskin Cesti	Loot	Level 24 Weapon Coffer
Steel Daggers	Loot	Level 24 Weapon Coffer
Wrapped Elm Longbow	Loot	Level 24 Weapon Coffer
Toothed Staghorn Staff	Loot	Level 24 Weapon Coffer
Goatskin Grimoire	Loot	Level 24 Weapon Coffer
Yew Crook	Loot	Level 24 Weapon Coffer
Elm Macuahuitl	Loot	Level 28 Weapon Coffer
Goatskin Targe	Loot	Level 28 Weapon Coffer
Spiked Steel Labrys	Loot	Level 28 Weapon Coffer
Steel Halberd	Loot	Level 28 Weapon Coffer
Steel Claws	Loot	Level 28 Weapon Coffer
Steel Knives	Loot	Level 28 Weapon Coffer
Ash Composite Bow	Loot	Level 28 Weapon Coffer
Silver Scepter	Loot	Level 28 Weapon Coffer
Engraved Goatskin Grimoire	Loot	Level 28 Weapon Coffer
Yew Wand	Loot	Level 28 Weapon Coffer
Walnut Macuahuitl	Loot	Level 34 Weapon Coffer
Decorated Buckler	Loot	Level 34 Weapon Coffer
Steel Bhuj	Loot	Level 34 Weapon Coffer
Heavy Steel Lance	Loot	Level 34 Weapon Coffer
Boarskin Himantes	Loot	Level 34 Weapon Coffer
Steel Baselards	Loot	Level 34 Weapon Coffer
Oak Longbow	Loot	Level 34 Weapon Coffer
Toothed Goathorn Staff	Loot	Level 34 Weapon Coffer
Book of Silver	Loot	Level 34 Weapon Coffer
Oak Radical	Loot	Level 34 Weapon Coffer
Steel Longsword	Loot	Level 36 Weapon Coffer
Decorated Iron Scutum	Loot	Level 36 Weapon Coffer
Spiked Mythril Labrys	Loot	Level 36 Weapon Coffer
Yarzonshell Harpoon	Loot	Level 36 Weapon Coffer
Mythril Claws	Loot	Level 36 Weapon Coffer
Mythril Knives	Loot	Level 36 Weapon Coffer
Mythril Cavalry Bow	Loot	Level 36 Weapon Coffer
Fire Brand	Loot	Level 36 Weapon Coffer
Embossed Book of Silver	Loot	Level 36 Weapon Coffer
Pastoral Oak Cane	Loot	Level 36 Weapon Coffer
Plumed Oak Macuahuitl	Loot	Level 40 Weapon Coffer
Raptorskin Targe	Loot	Level 40 Weapon Coffer
Mythril Bhuj	Loot	Level 40 Weapon Coffer
Mythril Lance	Loot	Level 40 Weapon Coffer
Tortoiseshell Hora	Loot	Level 40 Weapon Coffer
Mythril Baselards	Loot	Level 40 Weapon Coffer
Oak Composite Bow	Loot	Level 40 Weapon Coffer
Lightning Brand	Loot	Level 40 Weapon Coffer
Book of Mythril	Loot	Level 40 Weapon Coffer
Wand of Frost	Loot	Level 40 Weapon Coffer
Cobalt Shamshir	Loot	Level 45 Weapon Coffer
Eagle-crested Round Shield	Loot	Level 45 Weapon Coffer
Buccaneer's Bardiche	Loot	Level 45 Weapon Coffer
Cobalt Trident	Loot	Level 45 Weapon Coffer
Peisteskin Cesti	Loot	Level 45 Weapon Coffer
Mythril Pugiones	Loot	Level 45 Weapon Coffer
Yew Longbow	Loot	Level 45 Weapon Coffer
Water Brand	Loot	Level 45 Weapon Coffer
Book of Electrum	Loot	Level 45 Weapon Coffer
Wand of Flames	Loot	Level 45 Weapon Coffer
Cobalt Winglet	Loot	Level 49 Weapon Coffer
Cobalt Bladed Lantern Shield	Loot	Level 49 Weapon Coffer
Spiked Cobalt Labrys	Loot	Level 49 Weapon Coffer
Hart Guisarme	Loot	Level 49 Weapon Coffer
Cobalt Claws	Loot	Level 49 Weapon Coffer
Cobalt Baselards	Loot	Level 49 Weapon Coffer
Crab Bow	Loot	Level 49 Weapon Coffer
Ivory Staff	Loot	Level 49 Weapon Coffer
Embossed Book of Electrum	Loot	Level 49 Weapon Coffer
Pastoral Mahogany Cane	Loot	Level 49 Weapon Coffer
Giantsgall Longsword	Loot	Level 70 Weapon Coffer
Darksteel Scutum	Loot	Level 70 Weapon Coffer
Giantsgall War Axe	Loot	Level 70 Weapon Coffer
Giantsgall Trident	Loot	Level 70 Weapon Coffer
Giantsgall Claws	Loot	Level 70 Weapon Coffer
Giantsgall Cleavers	Loot	Level 70 Weapon Coffer
Giantsgall Longbow	Loot	Level 70 Weapon Coffer
Giantsgall Longstaff	Loot	Level 70 Weapon Coffer
Cantamina Thavnaria	Loot	Level 70 Weapon Coffer
Giantsgall Cane	Loot	Level 70 Weapon Coffer
Medica Thavnaria	Loot	Level 70 Weapon Coffer
Break Blade	Loot	Level 90 Weapon Coffer
Onion Shield	Loot	Level 90 Weapon Coffer
Dual Haken	Loot	Level 90 Weapon Coffer
Holy Lance	Loot	Level 90 Weapon Coffer
Hellish Claws	Loot	Level 90 Weapon Coffer
Air Knives	Loot	Level 90 Weapon Coffer
Elfin Bow	Loot	Level 90 Weapon Coffer
Elder Staff	Loot	Level 90 Weapon Coffer
Omnitome	Loot	Level 90 Weapon Coffer
Omnirod	Loot	Level 90 Weapon Coffer
Cognitome	Loot	Level 90 Weapon Coffer
Burtgang	Loot	Level 110 Weapon Coffer
Noct Hoplon	Loot	Level 110 Weapon Coffer
Conquerer	Loot	Level 110 Weapon Coffer
Liberator	Loot	Level 110 Weapon Coffer
Glanzfaust	Loot	Level 110 Weapon Coffer
Vajras	Loot	Level 110 Weapon Coffer
Rosenbogen	Loot	Level 110 Weapon Coffer
Laevateinn	Loot	Level 110 Weapon Coffer
Book of Spades	Loot	Level 110 Weapon Coffer
Yagrush	Loot	Level 110 Weapon Coffer
Book of Diamonds	Loot	Level 110 Weapon Coffer
Hellhound Helm	Loot	Hellhound Attire Coffer
Hellhound Armor	Loot	Hellhound Attire Coffer
Hellhound Gauntlets	Loot	Hellhound Attire Coffer
Hellhound Cuisses	Loot	Hellhound Attire Coffer
Hellhound Sabatons	Loot	Hellhound Attire Coffer
Grey Hound Helm	Loot	Grey Hound Armor Coffer
Grey Hound Armor	Loot	Grey Hound Armor Coffer
Grey Hound Gauntlets	Loot	Grey Hound Armor Coffer
Grey Hound Cuisses	Loot	Grey Hound Armor Coffer
Grey Hound Sabatons	Loot	Grey Hound Armor Coffer
Barghest Helm	Loot	Barghest Attire Coffer
Barghest Armor	Loot	Barghest Attire Coffer
Barghest Gauntlets	Loot	Barghest Attire Coffer
Barghest Cuisses	Loot	Barghest Attire Coffer
Barghest Sabatons	Loot	Barghest Attire Coffer
Moddey Dhoo Helm	Loot	Moddey Dhoo Attire Coffer
Moddey Dhoo Armor	Loot	Moddey Dhoo Attire Coffer
Moddey Dhoo Gauntlets	Loot	Moddey Dhoo Attire Coffer
Moddey Dhoo Cuisses	Loot	Moddey Dhoo Attire Coffer
Moddey Dhoo Sabatons	Loot	Moddey Dhoo Attire Coffer
Koro Kabuto	Loot	Koro Armor Coffer
Koro Oyoroi	Loot	Koro Armor Coffer
Koro Kote	Loot	Koro Armor Coffer
Koro Tsutsu-hakama	Loot	Koro Armor Coffer
Koro Sune-ate	Loot	Koro Armor Coffer
Gunro Kabuto	Loot	Gunro Armor Coffer
Gunro Oyoroi	Loot	Gunro Armor Coffer
Gunro Kote	Loot	Gunro Armor Coffer
Gunro Tsutsu-hakama	Loot	Gunro Armor Coffer
Gunro Sune-ate	Loot	Gunro Armor Coffer
Shadowstalker's Helm	Loot	Shadowstalker's Attire Coffer
Shadowstalker's Armor	Loot	Shadowstalker's Attire Coffer
Shadowstalker's Gauntlets	Loot	Shadowstalker's Attire Coffer
Shadowstalker's Breeches	Loot	Shadowstalker's Attire Coffer
Shadowstalker's Sabatons	Loot	Shadowstalker's Attire Coffer
Shadowcleaver's Helm	Loot	Shadowcleaver's Attire Coffer
Shadowcleaver's Armor	Loot	Shadowcleaver's Attire Coffer
Shadowcleaver's Gauntlets	Loot	Shadowcleaver's Attire Coffer
Shadowcleaver's Breeches	Loot	Shadowcleaver's Attire Coffer
Shadowcleaver's Sabatons	Loot	Shadowcleaver's Attire Coffer
Skysteel Saw	Loot	Skysteel Prototype Coffer
Skysteel Cross-pein Hammer	Loot	Skysteel Prototype Coffer
Skysteel Raising Hammer	Loot	Skysteel Prototype Coffer
Skysteel Lapidary Hammer	Loot	Skysteel Prototype Coffer
Skysteel Round Knife	Loot	Skysteel Prototype Coffer
Skysteel Needle	Loot	Skysteel Prototype Coffer
Skysteel Alembic	Loot	Skysteel Prototype Coffer
Skysteel Frypan	Loot	Skysteel Prototype Coffer
Skysteel Pickaxe	Loot	Skysteel Prototype Coffer
Skysteel Hatchet	Loot	Skysteel Prototype Coffer
Skysteel Fishing Rod	Loot	Skysteel Prototype Coffer
Millfiend's Costume Cap	Loot	Millfiend's Costume Coffer
Millfiend's Costume Apron	Loot	Millfiend's Costume Coffer
Millfiend's Costume Halfgloves	Loot	Millfiend's Costume Coffer
Millfiend's Costume Kecks	Loot	Millfiend's Costume Coffer
Millfiend's Costume Workboots	Loot	Millfiend's Costume Coffer
Forgefiend's Costume Goggles	Loot	Forgefiend's Costume Coffer
Forgefiend's Costume Apron	Loot	Forgefiend's Costume Coffer
Forgefiend's Costume Work Gloves	Loot	Forgefiend's Costume Coffer
Forgefiend's Costume Trousers	Loot	Forgefiend's Costume Coffer
Forgefiend's Costume Leggings	Loot	Forgefiend's Costume Coffer
Hammerfiend's Costume Visor	Loot	Hammerfiend's Costume Coffer
Hammerfiend's Costume Apron	Loot	Hammerfiend's Costume Coffer
Hammerfiend's Costume Work Gloves	Loot	Hammerfiend's Costume Coffer
Hammerfiend's Costume Trousers	Loot	Hammerfiend's Costume Coffer
Hammerfiend's Costume Workboots	Loot	Hammerfiend's Costume Coffer
Gemfiend's Costume Monocle	Loot	Gemfiend's Costume Coffer
Gemfiend's Costume Vest	Loot	Gemfiend's Costume Coffer
Gemfiend's Costume Shortgloves	Loot	Gemfiend's Costume Coffer
Gemfiend's Costume Trousers	Loot	Gemfiend's Costume Coffer
Gemfiend's Costume Boots	Loot	Gemfiend's Costume Coffer
Hidefiend's Costume Cap	Loot	Hidefiend's Costume Coffer
Hidefiend's Costume Jacket	Loot	Hidefiend's Costume Coffer
Hidefiend's Costume Armlets	Loot	Hidefiend's Costume Coffer
Hidefiend's Costume Kecks	Loot	Hidefiend's Costume Coffer
Hidefiend's Costume Thighboots	Loot	Hidefiend's Costume Coffer
Boltfiend's Costume Top Hat	Loot	Boltfiend's Costume Coffer
Boltfiend's Costume Swallowtail	Loot	Boltfiend's Costume Coffer
Boltfiend's Costume Fingerstalls	Loot	Boltfiend's Costume Coffer
Boltfiend's Costume Slacks	Loot	Boltfiend's Costume Coffer
Boltfiend's Costume Boots	Loot	Boltfiend's Costume Coffer
Cauldronfiend's Costume Spectacles	Loot	Cauldronfiend's Costume Coffer
Cauldronfiend's Costume Coat	Loot	Cauldronfiend's Costume Coffer
Cauldronfiend's Costume Gloves	Loot	Cauldronfiend's Costume Coffer
Cauldronfiend's Costume Kecks	Loot	Cauldronfiend's Costume Coffer
Cauldronfiend's Costume Shoes	Loot	Cauldronfiend's Costume Coffer
Galleyfiend's Costume Toque	Loot	Galleyfiend's Costume Coffer
Galleyfiend's Costume Apron	Loot	Galleyfiend's Costume Coffer
Galleyfiend's Costume Mittens	Loot	Galleyfiend's Costume Coffer
Galleyfiend's Costume Trousers	Loot	Galleyfiend's Costume Coffer
Galleyfiend's Costume Pattens	Loot	Galleyfiend's Costume Coffer
Minefiend's Costume Helmet	Loot	Minefiend's Costume Coffer
Minefiend's Costume Work Shirt	Loot	Minefiend's Costume Coffer
Minefiend's Costume Work Gloves	Loot	Minefiend's Costume Coffer
Minefiend's Costume Slops	Loot	Minefiend's Costume Coffer
Minefiend's Costume Workboots	Loot	Minefiend's Costume Coffer
Fieldfiend's Costume Hat	Loot	Fieldfiend's Costume Coffer
Fieldfiend's Costume Shirt	Loot	Fieldfiend's Costume Coffer
Fieldfiend's Costume Halfgloves	Loot	Fieldfiend's Costume Coffer
Fieldfiend's Costume Slops	Loot	Fieldfiend's Costume Coffer
Fieldfiend's Costume Workboots	Loot	Fieldfiend's Costume Coffer
Tacklefiend's Costume Hat	Loot	Tacklefiend's Costume Coffer
Tacklefiend's Costume Jacket	Loot	Tacklefiend's Costume Coffer
Tacklefiend's Costume Work Gloves	Loot	Tacklefiend's Costume Coffer
Tacklefiend's Costume Slops	Loot	Tacklefiend's Costume Coffer
Tacklefiend's Costume Workboots	Loot	Tacklefiend's Costume Coffer
Scion Traveler's Mask	Loot	Scion Traveler's Attire Coffer
Scion Traveler's Jacket	Loot	Scion Traveler's Attire Coffer
Scion Traveler's Gloves	Loot	Scion Traveler's Attire Coffer
Scion Traveler's Trousers	Loot	Scion Traveler's Attire Coffer
Scion Traveler's Boots	Loot	Scion Traveler's Attire Coffer
Kupo Knit Cap	Loot	Coffer o' Kupos
Kupo Jacket	Loot	Coffer o' Kupos
Kupo Trousers	Loot	Coffer o' Kupos
Kupo Shoes	Loot	Coffer o' Kupos
Hraesvelgr Hat	Loot	Hraesvelgr Attire Coffer
Hraesvelgr Jacket	Loot	Hraesvelgr Attire Coffer
Hraesvelgr Gloves	Loot	Hraesvelgr Attire Coffer
Hraesvelgr Trousers	Loot	Hraesvelgr Attire Coffer
Hraesvelgr Boots	Loot	Hraesvelgr Attire Coffer
Cashmere Hood	Loot	Cashmere Attire Coffer
Cashmere Poncho	Loot	Cashmere Attire Coffer
Cashmere Slops	Loot	Cashmere Attire Coffer
Fur-lined Saurian Boots	Loot	Cashmere Attire Coffer
Casual Jacket	Loot	Casual Attire Coffer
Casual Halfslops	Loot	Casual Attire Coffer
Casual Boots	Loot	Casual Attire Coffer
Peacelover's Hat	Loot	Peacelover's Attire Coffer
Peacelover's Shirt	Loot	Peacelover's Attire Coffer
Peacelover's Gloves	Loot	Peacelover's Attire Coffer
Peacelover's Pantaloons	Loot	Peacelover's Attire Coffer
Peacelover's Longboots	Loot	Peacelover's Attire Coffer
Endless Summer Glasses	Loot	Endless Summer Coffer
Endless Summer Top	Loot	Endless Summer Coffer
Endless Summer Bottom	Loot	Endless Summer Coffer
Endless Summer Sandals	Loot	Endless Summer Coffer
Exclusive Far Eastern Journey Battle Staff	Loot	Far Eastern Journey Attire Coffer
Exclusive Far Eastern Journey Circlet	Loot	Far Eastern Journey Attire Coffer
Exclusive Far Eastern Journey Jacket	Loot	Far Eastern Journey Attire Coffer
Exclusive Far Eastern Journey Armlets	Loot	Far Eastern Journey Attire Coffer
Exclusive Far Eastern Journey Bottoms	Loot	Far Eastern Journey Attire Coffer
Exclusive Far Eastern Journey Shoes	Loot	Far Eastern Journey Attire Coffer
Ahriman Card	Loot	Bronze Triad Card
Coblyn Card	Loot	Bronze Triad Card
Goobbue Card	Loot	Bronze Triad Card
Magitek Death Claw Card	Loot	Bronze Triad Card
Pudding Card	Loot	Bronze Triad Card
Spriggan Card	Loot	Bronze Triad Card
Blue Dragon Card	Loot	Bronze Triad Card
Chimera Card	Loot	Bronze Triad Card
Delivery Moogle Card	Loot	Bronze Triad Card
Liquid Flame Card	Loot	Bronze Triad Card
Scarface Bugaal Ja Card	Loot	Bronze Triad Card
Succubus Card	Loot	Bronze Triad Card
Behemoth Card	Loot	Bronze Triad Card
Tozol Huatotl Card	Loot	Bronze Triad Card
Waukkeon Card	Loot	Bronze Triad Card
Amalj'aa Card	Loot	Silver Triad Card
Ixal Card	Loot	Silver Triad Card
Kobold Card	Loot	Silver Triad Card
Sylph Card	Loot	Silver Triad Card
Tataru Taru Card	Loot	Silver Triad Card
Siren Card	Loot	Silver Triad Card
Ferdiad Card	Loot	Silver Triad Card
Garuda Card	Loot	Silver Triad Card
Good King Moggle Mog XII Card	Loot	Silver Triad Card
Ifrit Card	Loot	Silver Triad Card
Titan Card	Loot	Silver Triad Card
Urianger Card	Loot	Silver Triad Card
Lahabrea Card	Loot	Silver Triad Card	Platinum Triad Card	Bronze Rowena Cup Classic Card	Bronze Durai Memorial Card	Silver Durai Memorial Card	Silver Tournament of Champions Card
Minfilia Card	Loot	Silver Triad Card
Baderon Tenfingers Card	Loot	Gold Triad Card
Gerolt Card	Loot	Gold Triad Card
Hoary Boulder & Coultenet Card	Loot	Gold Triad Card
Momodi Modi Card	Loot	Gold Triad Card
Mother Miounne Card	Loot	Gold Triad Card
Cid Garlond Card	Loot	Gold Triad Card
Leviathan Card	Loot	Gold Triad Card	Bronze Rowena Cup Classic Card	Silver Rowena Cup Classic Card	Gold Rowena Cup Classic Card
Ramuh Card	Loot	Gold Triad Card	Silver Tournament of Champions Card
Shiva Card	Loot	Gold Triad Card	Platinum Triad Card	Bronze Spinner's Pull Card
Ultima Weapon Card	Loot	Gold Triad Card	Platinum Triad Card	Gold Spinner's Pull Card	Gold Tournament of Champions Card
Kan-E-Senna Card	Loot	Gold Triad Card
Merlwyb Bloefhiswyn Card	Loot	Gold Triad Card
Raubahn Aldynn Card	Loot	Gold Triad Card
Warrior of Light Card	Loot	Gold Triad Card
Zidane Tribal Card	Loot	Gold Triad Card
Brachiosaur Card	Loot	Mythril Triad Card
Coeurlregina Card	Loot	Mythril Triad Card
Gilgamesh & Enkidu Card	Loot	Mythril Triad Card
Pipin Tarupin Card	Loot	Mythril Triad Card
Vedrfolnir Card	Loot	Mythril Triad Card
Odin Card	Loot	Mythril Triad Card	Bronze Durai Memorial Card
Bartz Klauser Card	Loot	Mythril Triad Card
Onion Knight Card	Loot	Mythril Triad Card
Terra Branford Card	Loot	Mythril Triad Card
Magitek Gunship Card	Loot	Imperial Triad Card
Magitek Vanguard Card	Loot	Imperial Triad Card
Magitek Predator Card	Loot	Imperial Triad Card
Magitek Sky Armor Card	Loot	Imperial Triad Card
Armored Weapon Card	Loot	Imperial Triad Card
Regula van Hydrus Card	Loot	Imperial Triad Card
Hobgoblin Card	Loot	Dream Triad Card
Fuath Card	Loot	Dream Triad Card
Iguana Card	Loot	Dream Triad Card
Eros Card	Loot	Dream Triad Card
Leannan Sith Card	Loot	Dream Triad Card
Philia Card	Loot	Dream Triad Card
Storge Card	Loot	Dream Triad Card
Titania Card	Loot	Dream Triad Card
Innocence Card	Loot	Dream Triad Card
Oracle of Light Card	Loot	Dream Triad Card
Archaeotania Card	Loot	Dream Triad Card
Alphinaud & Alisaie Card	Loot	Platinum Triad Card
F'lhaminn Card	Loot	Platinum Triad Card
Louisoix Leveilleur Card	Loot	Platinum Triad Card
Hraesvelgr Card	Loot	Platinum Triad Card
Nanamo Ul Namo Card	Loot	Platinum Triad Card	Silver Durai Memorial Card	Gold Rowena Cup Classic Card
Firion Card	Loot	Platinum Triad Card	Bronze Durai Memorial Card	Silver Durai Memorial Card	Gold Durai Memorial Card
Cecil Harvey Card	Loot	Platinum Triad Card	Bronze Spinner's Pull Card	Silver Spinner's Pull Card	Gold Spinner's Pull Card
Tidus Card	Loot	Platinum Triad Card	Bronze Rowena Cup Classic Card	Silver Rowena Cup Classic Card	Gold Rowena Cup Classic Card
Lightning Card	Loot	Platinum Triad Card	Bronze Tournament of Champions Card	Silver Tournament of Champions Card	Gold Tournament of Champions Card
# DUNGEONS
Guidance Node Card	Instance	The Fractal Continuum (Hard)
Genbu Card	Instance	Hells' Lid
Qitian Dasheng Card	Instance	The Swallow's Compass
Tokkapchi Card	Instance	Saint Mocianne's Arboretum (Hard)
Mist Dragon Card	Instance	The Burn
Prometheus Card	Instance	The Ghimlyt Dark
Philia Card	Instance	Holminster Switch
Eros Card	Instance	The Qitana Ravel
Storge Card	Instance	Malikah's Well
Seeker of Solitude Card	Instance	The Grand Cosmos
Unknown Card	Instance	Anamnesis Anyder
Mother Porxie Card	Instance	Matoya's Relict
Lunar Bahamut Card	Instance	Paglth'an

# TRIALS
## Normal mode
Byakko Card	Instance	The Jade Stoa	The Jade Stoa (Extreme)
Tsukuyomi Card	Instance	Castrum Fluminis	The Minstrel's Ballad: Tsukuyomi's Pain
Suzaku Card	Instance	Hells' Kier	Hells' Kier (Extreme)
Seiryu Card	Instance	The Wreath of Snakes	The Wreath of Snakes (Extreme)
Stormblood Gilgamesh Card	Instance	Kugane Ohashi
Titania Card	Instance	The Dancing Plague	The Dancing Plague (Extreme)
Innocence Card	Instance	The Crown Of The Immaculate	The Crown Of The Immaculate (Extreme)
Hades Card	Instance	The Dying Gasp	The Minstrel's Ballad: Hades's Elegy
Ruby Weapon Card	Instance	Cinder Drift	Cinder Drift (Extreme)
Shadowbringers Warrior of Light Card	Instance	The Seat of Sacrifice	The Seat of Sacrifice (Extreme)
Emerald Weapon Card	Instance	Castrum Marinum	Castrum Marinum (Extreme)
Diamond Weapon Card	Instance	The Cloud Deck	The Cloud Deck (Extreme)
## Extreme mode
Byakko Totem	Instance	The Jade Stoa (Extreme)
Lunar Totem	Instance	The Minstrel's Ballad: Tsukuyomi's Pain
Suzaku Totem	Instance	Hells' Kier (Extreme)
Seiryu Totem	Instance	The Wreath of Snakes (Extreme)
King Totem	Instance	The Dancing Plague (Extreme)
Immaculate Totem	Instance	The Crown Of The Immaculate (Extreme)
Hades Totem	Instance	The Minstrel's Ballad: Hades's Elegy
Ruby Totem	Instance	Cinder Drift (Extreme)
High Legatus Idol	Instance	Memoria Misera (Extreme)
Varis yae Galvus Card	Instance	Memoria Misera (Extreme)
Totem of Light	Instance	The Seat of Sacrifice (Extreme)
Emerald Totem	Instance	Castrum Marinum (Extreme)
Diamond Totem	Instance	The Cloud Deck (Extreme)
# RAIDS
Omega Card	Instance	Alphascape V3.0	Alphascape V4.0	Alphascape V4.0 (Savage)
Eden's Promise Card	Instance	Eden's Promise: Eternity	Eden's Promise: Eternity (Savage)
# TREASURE MAP DUNGEONS
Pellitory	Instance	The Aquapolis
Thavnairian Armlets	Instance	The Aquapolis
Thavnairian Babouches	Instance	The Aquapolis
Thavnairian Bolero	Instance	The Aquapolis
Thavnairian Bustier	Instance	The Aquapolis
Thavnairian Gloves	Instance	The Aquapolis
Thavnairian Headdress	Instance	The Aquapolis
Thavnairian Sandals	Instance	The Aquapolis
Thavnairian Sarouel	Instance	The Aquapolis
Thavnairian Tights	Instance	The Aquapolis
Thavnairian Turban	Instance	The Aquapolis
Falconer's Boots	Instance	The Aquapolis
Falconer's Bottoms	Instance	The Aquapolis
Falconer's Shirt	Instance	The Aquapolis
Expeditioner's Cap	Instance	The Aquapolis
Expeditioner's Coat	Instance	The Aquapolis
Expeditioner's Flyers	Instance	The Aquapolis
Expeditioner's Gloves	Instance	The Aquapolis
Expeditioner's Kecks	Instance	The Aquapolis
Expeditioner's Moccasins	Instance	The Aquapolis
Expeditioner's Pantalettes	Instance	The Aquapolis
Expeditioner's Tabard	Instance	The Aquapolis
Expeditioner's Thighboots	Instance	The Aquapolis
Twilight over Thanalan Orchestrion Roll	Instance	The Aquapolis
Whisper of the Land Orchestrion Roll	Instance	The Aquapolis
On Windy Meadows Orchestrion Roll	Instance	The Aquapolis
Minute Mindflayer	Instance	The Aquapolis
Wind-up Tonberry	Instance	The Aquapolis
Baby Opo-opo	Instance	The Aquapolis
Mummy's Little Mummy	Instance	The Aquapolis
Nutkin	Instance	The Aquapolis
Owlet	Instance	The Aquapolis
Paissa Brat	Instance	The Aquapolis
Page 63	Instance	The Aquapolis
Bluebird	Instance	The Aquapolis
Dwarf Rabbit	Instance	The Aquapolis
Unicolt	Instance	The Aquapolis
Lesser Panda	Instance	The Aquapolis
Ugly Duckling	Instance	The Aquapolis
Tiny Bulb	Instance	The Aquapolis
Tight-beaked Parrot	Instance	The Aquapolis
Glass Fiber	Instance	The Aquapolis
Carbon Fiber	Instance	The Aquapolis
Luminous Fiber	Instance	The Aquapolis
Odorless Animal Fat	Instance	The Aquapolis
Astral Silk	Instance	The Aquapolis
Moonbeam Silk	Instance	The Aquapolis
Skyspring Water	Instance	The Aquapolis
Luminous Fiber	Instance	The Aquapolis
Plundered Treasure	Instance	The Aquapolis
Wool Top	Instance	The Aquapolis
New World Macrame	Instance	The Aquapolis
Bronze-trimmed Sack	Instance	The Palace of the Dead (Floors 1-10)	The Palace of the Dead (Floors 11-20)	The Palace of the Dead (Floors 21-30)	The Palace of the Dead (Floors 31-40)	The Palace of the Dead (Floors 41-50)
Iron-trimmed Sack	Instance	The Palace of the Dead (Floors 51-60)	The Palace of the Dead (Floors 61-70)	The Palace of the Dead (Floors 71-80)	The Palace of the Dead (Floors 81-90)	The Palace of the Dead (Floors 91-100)
Silver-trimmed Sack	Instance	The Palace of the Dead (Floors 101-110)	The Palace of the Dead (Floors 111-120)	The Palace of the Dead (Floors 121-130)	The Palace of the Dead (Floors 131-140)	The Palace of the Dead (Floors 141-150)
Gold-trimmed Sack	Instance	The Palace of the Dead (Floors 151-160)	The Palace of the Dead (Floors 161-170)	The Palace of the Dead (Floors 171-180)	The Palace of the Dead (Floors 181-190)	The Palace of the Dead (Floors 191-200)
Silver-haloed Sack	Instance	Heaven-on-High (Floors 1-10)	Heaven-on-High (Floors 11-20)	Heaven-on-High (Floors 21-30)
Gold-haloed Sack	Instance	Heaven-on-High (Floors 31-40)	Heaven-on-High (Floors 41-50)	Heaven-on-High (Floors 51-60)	Heaven-on-High (Floors 61-70)
Platinum-haloed Sack	Instance	Heaven-on-High (Floors 71-80)	Heaven-on-High (Floors 81-90)	Heaven-on-High (Floors 91-100)
Ratanhia Leaves	Instance	The Lost Canals of Uznair
Wind-up Namazu	Instance	The Lost Canals of Uznair	The Hidden Canals of Uznair
Nagxian Silk	Instance	The Lost Canals of Uznair	The Hidden Canals of Uznair
Nagxian Leather	Instance	The Lost Canals of Uznair
Matanga Lamp	Instance	The Lost Canals of Uznair
The Twin Faces of Fate - The Theme of Ul'dah Orchestrion Roll	Instance	The Lost Canals of Uznair	The Hidden Canals of Uznair
Navigator's Glory - The Theme of Limsa Lominsa Orchestrion Roll	Instance	The Lost Canals of Uznair	The Hidden Canals of Uznair
Born of the Boughs - The Theme of Gridania Orchestrion Roll	Instance	The Lost Canals of Uznair	The Hidden Canals of Uznair
Cracked Cluster	Instance	The Lost Canals of Uznair
Taoist's Wool	Instance	The Lost Canals of Uznair
Autumnal Maple Tree	Instance	The Lost Canals of Uznair
Maple Leaf Pile	Instance	The Lost Canals of Uznair
Holy Linen	Instance	The Lost Canals of Uznair	The Hidden Canals of Uznair
Hannish Wool	Instance	The Lost Canals of Uznair	The Hidden Canals of Uznair
Thavnairian Wool	Instance	The Lost Canals of Uznair	The Hidden Canals of Uznair
Timeworn Thief's Map	Instance	The Lost Canals of Uznair	The Shifting Altars of Uznair
A Father's Pride Orchestrion Roll	Instance	The Hidden Canals of Uznair
Ala Mhigan Weave	Instance	The Hidden Canals of Uznair
Wind-up Matanga	Instance	The Hidden Canals of Uznair
Crimson Sunrise Orchestrion Roll	Instance	The Hidden Canals of Uznair
Ballroom Etiquette - Scholarly Certitude	Instance	The Lost Canals of Uznair	The Hidden Canals of Uznair	The Shifting Altars of Uznair
Whisperfine Fleece	Instance	The Lost Canals of Uznair	The Shifting Altars of Uznair
Divine Chandelier	Instance	The Lost Canals of Uznair	The Shifting Altars of Uznair
Birdbath	Instance	The Lost Canals of Uznair	The Shifting Altars of Uznair
Little Chef's Playset	Instance	The Lost Canals of Uznair	The Shifting Altars of Uznair
Capybara Pup	Instance	The Lost Canals of Uznair	The Hidden Canals of Uznair	The Shifting Altars of Uznair
Hedgehoglet	Instance	The Lost Canals of Uznair	The Hidden Canals of Uznair	The Shifting Altars of Uznair
The Gold Whisker	Instance	The Shifting Altars of Uznair
A Better Tomorrow Orchestrion Roll	Instance	The Dungeons of Lyhe Ghiah	The Shifting Oubliettes of Lyhe Ghiah
Calf Leather	Instance	The Dungeons of Lyhe Ghiah
Cloth-softening Powder	Instance	The Dungeons of Lyhe Ghiah	The Shifting Oubliettes of Lyhe Ghiah
Dangerous Words Orchestrion Roll	Instance	The Dungeons of Lyhe Ghiah
Frontier Cloth	Instance	The Dungeons of Lyhe Ghiah	The Shifting Oubliettes of Lyhe Ghiah
Insatiable Orchestrion Roll	Instance	The Dungeons of Lyhe Ghiah
On Our Fates Alight Orchestrion Roll	Instance	The Dungeons of Lyhe Ghiah
Seacloth	Instance	The Dungeons of Lyhe Ghiah	The Shifting Oubliettes of Lyhe Ghiah
Shell Leather	Instance	The Dungeons of Lyhe Ghiah	The Shifting Oubliettes of Lyhe Ghiah
Sungold Talos	Instance	The Dungeons of Lyhe Ghiah
Tomorrow and Tomorrow - Reprise Orchestrion Roll	Instance	The Dungeons of Lyhe Ghiah	The Shifting Oubliettes of Lyhe Ghiah
Wind-up Fuath	Instance	The Dungeons of Lyhe Ghiah
Ballroom Etiquette - Decadent Decoration	Instance	The Shifting Oubliettes of Lyhe Ghiah
Everywhere and Nowhere Orchestrion Roll	Instance	The Shifting Oubliettes of Lyhe Ghiah
Golden Beaver	Instance	The Shifting Oubliettes of Lyhe Ghiah
Unmatching Pieces Orchestrion Roll	Instance	The Shifting Oubliettes of Lyhe Ghiah
Blue Oldroses	Gardening	Oldrose Seeds
Yellow Oldroses	Gardening	Oldrose Seeds
Green Oldroses	Gardening	Oldrose Seeds
Orange Oldroses	Gardening	Oldrose Seeds
Purple Oldroses	Gardening	Oldrose Seeds
White Oldroses	Gardening	Oldrose Seeds
Black Oldroses	Gardening	Oldrose Seeds
Rainbow Oldroses	Gardening	Oldrose Seeds
Red Violas	Gardening	Viola Seeds
Blue Violas	Gardening	Viola Seeds
Yellow Violas	Gardening	Viola Seeds
Green Violas	Gardening	Viola Seeds
Orange Violas	Gardening	Viola Seeds
White Violas	Gardening	Viola Seeds
Black Violas	Gardening	Viola Seeds
Rainbow Violas	Gardening	Viola Seeds
Blue Cherry Blossoms	Gardening	Shroud Cherry Sapling
Yellow Cherry Blossoms	Gardening	Shroud Cherry Sapling
Green Cherry Blossoms	Gardening	Shroud Cherry Sapling
Orange Cherry Blossoms	Gardening	Shroud Cherry Sapling
Purple Cherry Blossoms	Gardening	Shroud Cherry Sapling
White Cherry Blossoms	Gardening	Shroud Cherry Sapling
Black Cherry Blossoms	Gardening	Shroud Cherry Sapling
Pink Cherry Blossoms	Gardening	Shroud Cherry Sapling
Red Daisies	Gardening	Daisy Seeds
Blue Daisies	Gardening	Daisy Seeds
Green Daisies	Gardening	Daisy Seeds
Orange Daisies	Gardening	Daisy Seeds
Purple Daisies	Gardening	Daisy Seeds
White Daisies	Gardening	Daisy Seeds
Black Daisies	Gardening	Daisy Seeds
Rainbow Daisies	Gardening	Daisy Seeds
Mossy Stone Sword	Venture	Field Exploration XII	Field Exploration XIV
Mossy Stone Claws	Venture	Field Exploration XII	Field Exploration XIV
Mossy Stone Spear	Venture	Field Exploration XII	Field Exploration XIV
Mossy Stone Rod	Venture	Field Exploration XII	Field Exploration XIV
Mossy Stone Staff	Venture	Field Exploration XII	Field Exploration XIV
Mossy Stone Bow	Venture	Field Exploration XII	Field Exploration XIV
Mossy Stone Axe	Venture	Field Exploration XII	Field Exploration XIV
Littlefoot	Venture	Woodland Exploration XIV	Woodland Exploration XV	Woodland Exploration XVI
Gestahl	Venture	Waterside Exploration XVIII
Miniature Minecart	Venture	Highland Exploration XIV	Highland Exploration XVIII
Iron Giant Scrap	Venture	Field Exploration XVIII
Steel Mainspring	Venture	Highland Exploration XVIII
Minute Mindflayer	Venture	Field Exploration XIII	Highland Exploration XIII
Tiny Tapir	Venture	Field Exploration XIV
Gysahl Ring	Venture	Field Exploration X
Lupin Seedling	Venture	Woodland Exploration XVIII	Woodland Exploration XIX
Odder Otter	Venture	Woodland Exploration XX	Highland Exploration XX	Waterside Exploration XX	Highland Exploration XXII
Light Steel Plate	Venture	Field Exploration XIII	Highland Exploration XIII	Waterside Exploration XIII
Weathered Tome	Venture	Woodland Exploration XIV
Faded Tome	Venture	Waterside Exploration XII
Taffeta Cloth	Venture	Field Exploration XIII	Field Exploration XVII	Field Exploration XVIII	Highland Exploration XIII
Mameshiba	Venture	Highland Exploration XXII
Koala Joey	Venture	Field Exploration XXII
Axolotl Eft	Venture	Waterside Exploration XXII
Tengu Doll	Venture	Field Exploration XXII
Mystic Weapon	Venture	Field Exploration XXV
Wind-up Hobgoblin	Venture	Highland Exploration XXV
Domakin	Venture	Waterside Exploration XXV
Bacon Bits	Venture	Woodland Exploration XXV
Crabe de la Crabe	Venture	Waterside Exploration XXVII	Waterside Exploration XXVI
Abroader Otter	Voyage	Deep-sea site 7	Sea of Ash 2	Sea of Ash 3	Nald'thal's Pipe	The Isle of Sacrament
Aetherochemical Fiber	Voyage	Sea of Clouds 14	Sea of Clouds 15
Althyk Lavender Seeds	Voyage	Sea of Clouds 13	Sea of Clouds 15
Antique Leather	Voyage	Sea of Clouds 20
Aurelia Polyp	Voyage	Deep-sea site 3	The Umbrella Narrow	Glutton's Belly	Sea of Jade 1
Aurum Regis Sand	Voyage	Glittersand Basin
Balsa Wood Lumber	Voyage	Sea of Clouds 08	Sea of Clouds 09	Komura	Flickering Dip
Balsa Wood Scrap	Voyage	Sea of Clouds 03	Sea of Clouds 04	The Umbrella Narrow
Bamboo Weave	Voyage	Sea of Clouds 01	Sea of Clouds 02	Deep-sea site 1	Deep-sea site 2	Deep-sea site 3	The Umbrella Narrow	The Cobalt Shoals
Battledance Materia II	Voyage	Sea of Clouds 02
Battledance Materia III	Voyage	Sea of Clouds 02	Sea of Clouds 20
Battledance Materia IV	Voyage	Sea of Clouds 20	Komura
Battledance Materia V	Voyage	Sea of Clouds 20
Bear Fat	Voyage	Sea of Clouds 23
Birch Branch	Voyage	Sea of Clouds 05	Sea of Clouds 11	Sea of Clouds 17	The Umbrella Narrow	Deep-sea site 4
Birch Log	Voyage	Komura
Black Clay	Voyage	Sea of Clouds 10
Black Scorpion	Voyage	Coldtoe Isle
Bluespirit Ore	Voyage	Rogo-Tumu-Here's Haunt
Cassia Log	Voyage	Sea of Clouds 14	Sea of Clouds 15	Sea of Clouds 16	Sea of Clouds 17	Sea of Clouds 18	Sea of Clouds 19	Sea of Clouds 20	Sea of Clouds 21	Sea of Clouds 23	Sea of Clouds 24	Deep-sea Site 6	Deep-sea Site 7
Cerulean Crystal Boule	Voyage	The Central Charnel Trench	The Blue Hole
Chemically Treated Chimera Hide	Voyage	Sea of Clouds 11	Sea of Clouds 12	Sea of Clouds 13
Cloudsbreath Seeds	Voyage	Sea of Clouds 17	Sea of Clouds 21	Sea of Clouds 24
Cocobolo Lumber	Voyage	South Isle of Zozonan	Wreckage of the Windwalker	Sea of Ash 1	Sea of Ash 2	The Lone Glove	Coldtoe Isle	The Open Robe	The Blue Hole
Copper Voyage Spoil	Voyage	Sea of Clouds 09
Craftsman's Command Materia II	Voyage	Sea of Clouds 07	The Umbrella Narrow
Craftsman's Command Materia III	Voyage	Sea of Clouds 03	Sea of Clouds 07	Sea of Clouds 17	Deep-sea site 2
Craftsman's Command Materia IV	Voyage	Sea of Clouds 17
Craftsman's Competence Materia III	Voyage	Sea of Clouds 03	Sea of Clouds 17	Deep-sea site 2
Craftsman's Competence Materia IV	Voyage	Sea of Clouds 13	Sea of Clouds 17
Craftsman's Cunning Materia III	Voyage	Sea of Clouds 07	The Cobalt Shoals
Craftsman's Cunning Materia IV	Voyage	Sea of Clouds 13
Crimson Coral	Voyage	The Lightless Basin	The Southern Charnel Trench
Cryptomeria Log	Voyage	Wreckage of the Windwalker	Sea of Ash 1	The Central Charnel Trench	Sea of Ash 4	Coldtoe Isle	The Open Robe
Crystal Boule	Voyage	Wreckage of the Windwalker	Sunken Valut	Stone Temple
Dark Chestnut Branch	Voyage	Sea of Clouds 06	Sea of Clouds 12	Sea of Clouds 18	Sea of Clouds 24	Offender's Rot	Deep-sea site 3
Deep-blue Cluster	Voyage	Sea of Clouds 13	Sea of Clouds 19	Sea of Clouds 22	The Central Rimilala Trench	Deep-sea Site 5
Deep-blue Crystal	Voyage	Sea of Clouds 07	Sea of Clouds 10	Sea of Clouds 13	The Umbrella Narrow	The Cobalt Shoals
Deep-green Cluster	Voyage	Sea of Clouds 18	Sea of Clouds 21	Sea of Clouds 24	Komura
Deep-green Crystal	Voyage	Sea of Clouds 03	Sea of Clouds 06	Sea of Clouds 15	Southern Rimilala Trench
Deep-red Cluster	Voyage	Sea of Clouds 17	Sea of Clouds 20	Sea of Clouds 23	Kanayama	Glittersand Basin	Rogo-Tumu-Here's Haunt
Deep-red Crystal	Voyage	Sea of Clouds 05	Deep-sea site 3	Neolith Island	Deep-sea site 3
Dimythrite Ore	Voyage	Rogo-Tumu-Here's Repose
Dimythrite Sand	Voyage	Sea of Jade 1
Dinosaur Fossil	Voyage	Purgatory
Dinosaur Leather	Voyage	Sea of Clouds 19
Dravanian Mote	Voyage	Sea of Clouds 06	Sea of Clouds 13
Dusk Leather	Voyage	Sea of Clouds 17	Sea of Clouds 18	Sea of Clouds 19	Sea of Clouds 20	Sea of Clouds 21	Sea of Clouds 22
Earth Crystal	Voyage	Sea of Clouds 03	Sea of Clouds 06	Sea of Clouds 11	Sea of Clouds 13	Sea of Clouds 14	Sea of Clouds 15	Deep-sea site 1
Emerald	Voyage	Unidentified Derelict	The Wreckage of Discovery I
Emerald Crystal Boule	Voyage	Sea of Ash 3	The Open Robe
Empty Cluster	Voyage	Sea of Clouds 16
Empty Crystal	Voyage	Sea of Clouds 05	Sea of Clouds 06	The Lightless Basin	Neolith Island	Deep-sea site 3
Faded Copy of A World Apart	Voyage	Sea of Clouds 23
Faded Copy of Ambient Abyss	Voyage	The Mystic Basin	Deep-sea Site 5	The Rimilala Shelf	Flickering Dip
Far Eastern Coin	Voyage	Sea of Clouds 16
Ferberite	Voyage	Sea of Clouds 01	Sea of Clouds 07	Sea of Clouds 13	Sea of Clouds 19	Sea of Clouds 23
Fine Alumen	Voyage	Sea of Clouds 04	Sea of Clouds 07	Sea of Clouds 13
Fire Crystal	Voyage	Sea of Clouds 02	Sea of Clouds 04	Sea of Clouds 07	Sea of Clouds 10	Sea of Clouds 12	Sea of Clouds 16	Sunken Vault
Fire Cluster	Voyage	Deep-sea Site 7
Gatherer's Grasp Materia III	Voyage	Sea of Clouds 04	Sea of Clouds 16	Sea of Clouds 22
Gatherer's Grasp Materia IV	Voyage	Sea of Clouds 16	Sea of Clouds 22
Gatherer's Guerdon Materia III	Voyage	Sea of Clouds 10
Gatherer's Guerdon Materia IV	Voyage	Sea of Clouds 16
Gatherer's Guile Materia III	Voyage	Sea of Clouds 04	Sea of Clouds 10	Sea of Clouds 22	The Lightless Basin
Gatherer's Guile Materia IV	Voyage	Sea of Clouds 22
Glamour Dispeller	Voyage	The Upwell
Gold Ingot	Voyage	Concealed Bay
Gold Ore	Voyage	Sea of Clouds 02	Sea of Clouds 08	Sea of Clouds 14	Sea of Clouds 20	The Wreckage of the Headway
Gold Sand	Voyage	Sea of Clouds 19
Golden Crystal Boule	Voyage	The Slipped Anchor
Golden Ewer	Voyage	Smuggler's Knot	The Blue Hole
Grade 6 Dark Matter	Voyage	The Upwell
Hardsilver Sand	Voyage	Glittersand Basin
Heavens' Eye Materia III	Voyage	Sea of Clouds 23
Heavens' Eye Materia IV	Voyage	Sea of Clouds 12	Sea of Clouds 14	Sea of Clouds 23
Heavens' Eye Materia V	Voyage	Sea of Clouds 23
Ice Crystal	Voyage	Sea of Clouds 03	Sea of Clouds 06	Sea of Clouds 11	Sea of Clouds 13	Sea of Clouds 14	Sea of Clouds 15	Deep-sea site 1	Neolith Island	Sunken Vault
Iron Giant Core	Voyage	Sea of Clouds 08	Sea of Clouds 14	Sea of Clouds 18	Sea of Clouds 19	Sea of Clouds 20	Sea of Clouds 22
Iron Voyage Spoil	Voyage	Sea of Clouds 24
Kamacite Ore	Voyage	Rimiala Shelf	Flickering Dip
Lightning Crystal	Voyage	Sea of Clouds 01	Sea of Clouds 05	Sea of Clouds 08	Sea of Clouds 09
Magnanimous Mogcrown	Voyage	Sea of Clouds 01	Sea of Clouds 10	Sea of Clouds 11	Sea of Clouds 15
Marble	Voyage	Flickering Dip
Marine Wax Ester	Voyage	Concealed Bay	Flickering Dip	The Wreckage of Discovery I	The Southern Charnel Trench
Meerkat	Voyage	Coldtoe Isle	The Open Robe	The Stone Barbs
Miracle Apple Log	Voyage	The Isle of Sacrament
Mythrite Sand	Voyage	Sea of Clouds 20	Glittersand Basin
Oriental Grass Tuft	Voyage	Sea of Clouds 08	Sea of Clouds 14
Pelagic Clay	Voyage	Nald'thal's Pipe
Piety Materia II	Voyage	Southern Rimilala Trench
Piety Materia III	Voyage	Sea of Clouds 06	Sea of Clouds 19	Deep-sea site 4
Piety Materia IV	Voyage	Sea of Clouds 19
Piety Materia V	Voyage	Sea of Clouds 19
Platinum Ingot	Voyage	Concealed Bay	Uncharted depths
Platinum Ore	Voyage	Sea of Clouds 03	Sea of Clouds 09	Sea of Clouds 15	Sea of Clouds 21
Potters Stone	Voyage	Sea of Clouds 01	Sea of Clouds 10
Pure Titanium Ore	Voyage	South Isle of Zozonan	North Isle of Zozonan	The Central Charnel Trench	The Midden Pit	The Lone Glove
Quickarm Materia III	Voyage	Sea of Clouds 09	Sea of Clouds 18
Quickarm Materia IV	Voyage	Sea of Clouds 18	Kanayama	Sea of Clouds 15
Quicktongue Materia II	Voyage	Sea of Clouds 06	Deep-sea site 1
Quicktongue Materia III	Voyage	Sea of Clouds 02	Sea of Clouds 06	Sea of Clouds 11	Sea of Clouds 21	Southern Rimilala Trench	Deep-sea site 4
Quicktongue Materia IV	Voyage	Sea of Clouds 11	Sea of Clouds 21
Raw Celestine	Voyage	Sea of Clouds 08	Sea of Clouds 09	Sea of Clouds 10	The Mystic Basin	Kanayama	Deep-sea site 4
Red Clay	Voyage	Sea of Clouds 07	The Stone Barbs
Red Moko Grass	Voyage	Sea of Clouds 03	Sea of Clouds 04	Deep-sea Site 3	Deep-sea Site 2	The Ivory Shoals	The Umbrella Narrow
Rose Gold Ingot	Voyage	The Wreckage of the Headway
Ruby	Voyage	The Wreckage of Discovery I
Ruby Crystal Boule	Voyage	The Catacombs of the Father	The Midden Pit	Nald'thal's Pipe
Salvaged Coinage	Voyage	Glutton's Belly
Salvaged Necklace	Voyage	Unidentified Derelict
Savage Aim Materia III	Voyage	Sea of Clouds 08	Sea of Clouds 15	Sea of Clouds 24	The Mystic Basin
Savage Aim Materia IV	Voyage	Sea of Clouds 15
Savage Aim Materia V	Voyage	Sea of Clouds 24
Savage Might Materia II	Voyage	Deep-sea site 3
Savage Might Materia III	Voyage	Sea of Clouds 05	Sea of Clouds 21	Deep-sea site 3
Savage Might Materia IV	Voyage	Sea of Clouds 21	Kanayama
Savage Might Materia V	Voyage	Sea of Clouds 21
Scarlet Sap	Voyage	Sea of Clouds 04	Sea of Clouds 10	Sea of Clouds 16	Sea of Clouds 22
Sharksucker-class Insubmersible	Voyage	The Southern Charnel Trench	The Central Charnel Trench	Sea of Ash 4	The Slipped Anchor
Shrub Seedling	Voyage	Sea of Clouds 02	Sea of Clouds 06	Sea of Clouds 12
Siltstone	Voyage	Flickering Dip
Silver Dasher	Voyage	The Open Robe	Rogo-Tumu-Here's Haunt
Silver Ore	Voyage	Sea of Clouds 17
Star Ruby	Voyage	Unidentified Derelict	The Wreckage of Discovery I
Star Sapphire	Voyage	Unidentified Derelict
Synthetic Fiber	Voyage	Sea of Clouds 11	Sea of Clouds 12	The Stone Barbs
Synthetic Resin	Voyage	Sea of Clouds 13
Tincalconite	Voyage	Sea of Clouds 07
Toy Box Schema	Voyage	Sea of Clouds 05	Sea of Clouds 09	Sea of Clouds 14	Sea of Clouds 17	Sea of Clouds 21
Unaspected Crystal	Voyage	Sea of Clouds 08	Sea of Clouds 10	The Ivory Shoals	Deep-sea Site 1	Deep-sea site 2	The Lightless Basin	Southern Rimilala Trench	The Umbrella Narrow	Offender's Rot	Neolith Island	The Cobalt Shoals	Deep-sea Site 4
Vivianite	Voyage	Sea of Clouds 01	Sea of Clouds 02	Deep-sea site 1	Kanayama	Deep-sea site 4	The Southern Rimilala Trench	Purgatory
Voidrake Seeds	Voyage	Sea of Clouds 12	Sea of Clouds 14	Sea of Clouds 16
Water Crystal	Voyage	Sea of Clouds 02	Sea of Clouds 04	Sea of Clouds 07	Sea of Clouds 10	Sea of Clouds 12	Sea of Clouds 16	Deep-sea site 2	Deep-sea site 3	Offender's Rot
White Ash Log	Voyage	The Stone Barbs
White Scorpion	Voyage	The Lone Glove
Wind Crystal	Voyage	Sea of Clouds 01	Sea of Clouds 05	Sea of Clouds 08	Sea of Clouds 09	Ivory Shoals	Deep-sea site 2	Deep-sea site 3	The Umbrella Narrow
Wind Cluster	Voyage	The Wreckage of the Headway
Wind Silk	Voyage	Sea of Clouds 13	Sea of Clouds 16	Sea of Clouds 17	Sea of Clouds 21
Hard to Miss Orchestrion Roll	Voyage	Tangaroa's Prow
Nemesis Orchestrion Roll	Voyage	Moergynn's Forge
Syldrion-class Insubmersible	Voyage	Sea of Jade 4
Cold-warped Lockbox	Other	Eureka Pagos, Mutated Mobs	Mutated Anubys
Frosted Protean Crystal	Other	Eureka Pagos, Crystal Forge
# Improper way to add those instance rewards, to improve when it'll be possible
# DUNGEONS
Below Orchestrion Roll	Instance	Copperbell Mines
The Ludus Orchestrion Roll	Instance	Halatali
The Maiden's Lament Orchestrion Roll	Instance	Haukke Manor
Abomination Orchestrion Roll	Instance	Cutter's Cry
The Darkhold Orchestrion Roll	Instance	Dzemael Darkhold
A Tonberry's Tears Orchestrion Roll	Instance	The Wanderer's Palace
Beneath Bloodied Banners Orchestrion Roll	Instance	Halatali (Hard)
Fury Orchestrion Roll	Instance	Brayflox's Longstop (Hard)
Upon the Rocks Orchestrion Roll	Instance	Pharos Sirius (Hard)
Tricksome Orchestrion Roll	Instance	The Wanderer's Palace (Hard)
Dancing Calcabrina Orchestrion Roll	Instance	The Antitower
The Ancient City Orchestrion Roll	Instance	The Lost City of Amdapor (Hard)
Gates of the Moon Orchestrion Roll	Instance	Doma Castle
Alienus Orchestrion Roll	Instance	Castrum Abania
Earth, Wind, and Water Orchestrion Roll	Instance	The Swallow's Compass
Monkey King	Instance	The Swallow's Compass
A Land Long Dead Orchestrion Roll	Instance	The Burn
From Mud Orchestrion Roll	Instance	Saint Mocianne's Arboretum (Hard)
Mudpie	Instance	Saint Mocianne's Arboretum (Hard)
Verdant Partition	Instance	Saint Mocianne's Arboretum (Hard)
A Pall Most Murderous Orchestrion Roll	Instance	The Ghimlyt Dark
Wind-up Weapon	Instance	The Ghimlyt Dark
Black Hayate	Instance	Holminster Switch
To Fire and Sword Orchestrion Roll	Instance	Holminster Switch
Figments Orchestrion Roll	Instance	Dohn Mheg
Tiny Echevore	Instance	Dohn Mheg
Chameleon	Instance	The Qitana Ravel
Unwound Orchestrion Roll	Instance	The Qitana Ravel
Armadillo Bowler	Instance	Malikah's Well
Deep Down Orchestrion Roll	Instance	Malikah's Well
Forgiven Hate	Instance	Mt. Gulg
In the Belly of the Beast Orchestrion Roll	Instance	Mt. Gulg
Mortal Instants Orchestrion Roll	Instance	Amaurot
Shoebill	Instance	Amaurot
A Long Fall Orchestrion Roll	Instance	The Twinning
Clionid Larva	Instance	Akadaemia Anyder
Shadows Withal Orchestrion Roll	Instance	Akadaemia Anyder
Cosmos Decoration	Instance	The Grand Cosmos
Cosmos Partition	Instance	The Grand Cosmos
Little Leannan	Instance	The Grand Cosmos
The Grand Cosmos Orchestrion Roll	Instance	The Grand Cosmos
Ancient One	Instance	Anamnesis Anyder
Floundering in the Depths Orchestrion Roll	Instance	Anamnesis Anyder
Ephemeral Necromancer	Instance	The Heroes' Gauntlet
Where All Roads Lead Orchestrion Roll	Instance	The Heroes' Gauntlet
Drippy	Instance	Matoya's Relict
Freshly Glazed Porxie Orchestrion Roll	Instance	Matoya's Relict
Magitek Predator F1	Instance	Paglth'an
Seven Flames Orchestrion Roll	Instance	Paglth'an
# TRIALS
Bismarck's Baleen	Instance	The Limitless Blue (Hard)	The Limitless Blue (Extreme)
Celestial Kimono Remnant	Instance	The Minstrel's Ballad: Tsukuyomi's Pain
Faded Copy of Under the Moonlight	Instance	The Minstrel's Ballad: Tsukuyomi's Pain
Lunar Kamuy Fife	Instance	The Minstrel's Ballad: Tsukuyomi's Pain
Poogie	Instance	The Great Hunt (Extreme)
Proof of a Hero - Monster Hunter: World Version Orchestrion Roll	Instance	The Great Hunt (Extreme)
Auspicious Kamuy Fife	Instance	The Jade Stoa (Extreme)
Byakko's Mane	Instance	The Jade Stoa (Extreme)
Euphonious Kamuy Fife	Instance	Hells' Kier (Extreme)
Faded Copy of Sunrise	Instance	Hells' Kier (Extreme)
Scarlet Tailfeather	Instance	Hells' Kier (Extreme)
Faded Copy of From the Dragon's Wake	Instance	The Wreath of Snakes (Extreme)
Hallowed Kamuy Fife	Instance	The Wreath of Snakes (Extreme)
Seiryu's Scale	Instance	The Wreath of Snakes (Extreme)
Yojimbo Barding	Instance	Kugane Ohashi
Dancing Wing	Instance	The Dancing Plague (Extreme)
Fae Gwiber Trumpet	Instance	The Dancing Plague (Extreme)
Faded Copy of What Angel Wakes Me	Instance	The Dancing Plague (Extreme)
Faded Copy of Insanity	Instance	The Crown of the Immaculate (Extreme)
Immaculate Wingblade	Instance	The Crown of the Immaculate (Extreme)
Innocent Gwiber Trumpet	Instance	The Crown of the Immaculate (Extreme)
Faded Copy of Invincible	Instance	The Minstrel's Ballad: Hades's Elegy
Hades's Auracite	Instance	The Minstrel's Ballad: Hades's Elegy
Shadow Gwiber Trumpet	Instance	The Minstrel's Ballad: Hades's Elegy
Faded Copy of Ultima (The Primals)	Instance	Cinder Drift (Extreme)
Ruby Gwiber Trumpet	Instance	Cinder Drift (Extreme)
Ruby Plating	Instance	Cinder Drift (Extreme)
Faded Copy of To the Edge	Instance	The Seat of Sacrifice (Extreme)
Gwiber of Light Trumpet	Instance	The Seat of Sacrifice (Extreme)
Plate of Light	Instance	The Seat of Sacrifice (Extreme)
Emerald Gwiber Trumpet	Instance	Castrum Marinum (Extreme)
Emerald Plating	Instance	Castrum Marinum (Extreme)
Faded Copy of The Black Wolf Stalks Again	Instance	Castrum Marinum (Extreme)
Diamond Gwiber Trumpet	Instance	The Cloud Deck (Extreme)
Diamond Plating	Instance	The Cloud Deck (Extreme)
Faded Copy of In the Arms of War	Instance	The Cloud Deck (Extreme)
# RAIDS
Neo Aetherstone - Foot Gear	Instance	The Final Coil of Bahamut - Turn 1	The Final Coil of Bahamut - Turn 3
Neo Aetherstone - Hand Gear	Instance	The Final Coil of Bahamut - Turn 1	The Final Coil of Bahamut - Turn 3
Neo Aetherstone - Headgear	Instance	The Final Coil of Bahamut - Turn 1	The Final Coil of Bahamut - Turn 2
Neo Aetherstone - Leg Gear	Instance	The Final Coil of Bahamut - Turn 2
Neo Aetherstone - Body Gear	Instance	The Final Coil of Bahamut - Turn 4
Omega Squared Orchestrion Roll	Instance	Deltascape V1.0	Deltascape V2.0	Deltascape V3.0
Decisions Orchestrion Roll	Instance	Deltascape V4.0
A Battle Decisively Orchestrion Roll	Instance	Sigmascape V1.0	Sigmascape V2.0	Sigmascape V3.0
Dancing Mad - Movement I Orchestrion Roll	Instance	Sigmascape V4.0
Dancing Mad - Movement II Orchestrion Roll	Instance	Sigmascape V4.0
Dancing Mad - Movement III Orchestrion Roll	Instance	Sigmascape V4.0
Wind-up Kefka	Instance	Sigmascape V4.0	Sigmascape V4.0 (Savage)
Battle Orchestrion Roll	Instance	Alphascape V1.0
Primogenitor Orchestrion Roll	Instance	Alphascape V2.0
eScape Orchestrion Roll	Instance	Alphascape V3.0
Heartless Orchestrion Roll	Instance	Alphascape V4.0
OMG	Instance	Alphascape V4.0	Alphascape V4.0 (Savage)
Apoplexy Orchestrion Roll	Instance	The Ridorana Lighthouse
Construct 8	Instance	The Ridorana Lighthouse
Flash of Steel Orchestrion Roll	Instance	The Ridorana Lighthouse
The Mystery of Giruvegan Orchestrion Roll	Instance	The Ridorana Lighthouse
A Man Consumed Orchestrion Roll	Instance	The Orbonne Monastery
Antipyretic Orchestrion Roll	Instance	The Orbonne Monastery
Pressure (No. 1) Orchestrion Roll	Instance	The Orbonne Monastery
Ultima's Perfection Orchestrion Roll	Instance	The Orbonne Monastery
Under the Stars Orchestrion Roll	Instance	The Orbonne Monastery
Wind-up Ramza	Instance	The Orbonne Monastery
Force Your Way Orchestrion Roll	Instance	Eden's Gate: Resurrection	Eden's Gate: Descent
Blinding Indigo Orchestrion Roll	Instance	Eden's Gate: Inundation
Eden Minor	Instance	Eden's Gate: Sepulture	Eden's Gate: Sepulture (Savage)
Landslide Orchestrion Roll	Instance	Eden's Gate: Sepulture
Twice Stricken Orchestrion Roll	Instance	Eden's Verse: Fulmination
Primal Angel Orchestrion Roll	Instance	Eden's Verse: Furor
Return to Oblivion Orchestrion Roll	Instance	Eden's Verse: Refulgence
Wind-up Ryne	Instance	Eden's Verse: Refulgence	Eden's Verse: Refulgence (Savage)
Don't Be Afraid Orchestrion Roll	Instance	Eden's Promise: Litany
The Legendary Beast Orchestrion Roll	Instance	Eden's Promise: Anamorphosis
Promises to Keep Orchestrion Roll	Instance	Eden's Promise: Eternity
The Extreme Orchestrion Roll	Instance	Eden's Promise: Eternity (Savage)
Wind-up Gaia	Instance	Eden's Promise: Eternity	Eden's Promise: Eternity (Savage)
Alien Manifestation Orchestrion Roll	Instance	The Copied Factory
Bipolar Nightmare Orchestrion Roll	Instance	The Copied Factory
City Ruins (Rays of Light) Orchestrion Roll	Instance	The Copied Factory
Pod 054	Instance	The Copied Factory
Pod 316	Instance	The Copied Factory
Song of the Ancients (Atonement) Orchestrion Roll	Instance	The Copied Factory
Weight of the World (Prelude Version) Orchestrion Roll	Instance	The Copied Factory
2B Automaton	Instance	The Puppets' Bunker
2P Automaton	Instance	The Puppets' Bunker
End of the Unknown Orchestrion Roll	Instance	The Puppets' Bunker
Fortress of Lies Orchestrion Roll	Instance	The Puppets' Bunker
Grandma (Destruction) Orchestrion Roll	Instance	The Puppets' Bunker
Torn from the Heavens／The Dark Colossus Destroys All (Medley Version) Orchestrion Roll	Instance	The Puppets' Bunker
2B Card	Instance	The Tower at Paradigm's Breach
9S Automaton	Instance	The Tower at Paradigm's Breach
Emil (Despair) Orchestrion Roll	Instance	The Tower at Paradigm's Breach
Kainé (Final Fantasy Main Theme Version) Orchestrion Roll	Instance	The Tower at Paradigm's Breach
Modern Aesthetics - Battle-ready Bobs	Instance	The Tower at Paradigm's Breach
Modern Aesthetics - Scanning for Style	Instance	The Tower at Paradigm's Breach
Mourning Orchestrion Roll	Instance	The Tower at Paradigm's Breach
Smaller Stubby	Instance	The Tower at Paradigm's Breach
Stuffed Android Units	Instance	The Tower at Paradigm's Breach
The Sound of the End Orchestrion Roll	Instance	The Tower at Paradigm's Breach
The Sound of the End: 8bit Orchestrion Roll	Instance	The Tower at Paradigm's Breach
Starbird	Instance	The Dead Ends
